,Rank,Country,Gold,Silver,Bronze,Total,Year,NOC
0,1,United States,11,7,2,20,1896,USA
1,2,Greece,10,18,19,47,1896,GRE
2,3,Germany,6,5,2,13,1896,GER
3,4,France,5,4,2,11,1896,FRA
4,5,Great Britain,2,3,2,7,1896,GBR
5,6,Hungary,2,1,3,6,1896,HUN
6,7,Austria,2,1,2,5,1896,AUT
7,8,Australia,2,0,0,2,1896,AUS
8,9,Denmark,1,2,3,6,1896,DEN
9,10,Switzerland,1,2,0,3,1896,SUI
10,11,Mixed team,1,0,1,2,1896,MIX
11,1,France,27,39,37,103,1900,FRA
12,2,United States,19,14,15,48,1900,USA
13,3,Great Britain,15,7,9,31,1900,GBR
14,4,Mixed team,8,5,6,19,1900,MIX
15,5,Belgium,6,7,4,17,1900,BEL
16,6,Switzerland,6,2,1,9,1900,SUI
17,7,Germany,4,3,2,9,1900,GER
18,8,Italy,3,2,0,5,1900,ITA
19,9,Australia,2,0,3,5,1900,AUS
20,10,Denmark,1,3,2,6,1900,DEN
21,11,Hungary,1,2,2,5,1900,HUN
22,12,Cuba,1,1,0,2,1900,CUB
23,13,Canada,1,0,1,2,1900,CAN
24,14,Spain,1,0,0,1,1900,ESP
25,14,Luxembourg,1,0,0,1,1900,LUX
26,16,Austria,0,3,3,6,1900,AUT
27,17,Norway,0,2,3,5,1900,NOR
28,17,Netherlands,0,2,3,5,1900,NED
29,19,India,0,2,0,2,1900,IND
30,20,Bohemia,0,1,1,2,1900,BOH
31,21,Sweden,0,0,1,1,1900,SWE
32,1,United States,76,78,77,231,1904,USA
33,2,Germany,4,5,6,15,1904,GER
34,3,Canada,4,1,1,6,1904,CAN
35,4,Cuba,3,0,0,3,1904,CUB
36,5,Hungary,2,1,1,4,1904,HUN
37,5,Mixed team,2,1,1,4,1904,MIX
38,7,Norway,2,0,0,2,1904,NOR
39,8,Austria,1,1,1,3,1904,AUT
40,9,Great Britain,1,1,0,2,1904,GBR
41,10,Switzerland,1,0,2,3,1904,SUI
42,11,Greece,1,0,1,2,1904,GRE
43,12,Australia,0,3,1,4,1904,AUS
44,13,France,0,1,0,1,1904,FRA
45,1,Great Britain,56,51,39,146,1908,GBR
46,2,United States,23,12,12,47,1908,USA
47,3,Sweden,8,6,11,25,1908,SWE
48,4,France,5,5,9,19,1908,FRA
49,5,Germany,3,5,5,13,1908,GER
50,6,Hungary,3,4,2,9,1908,HUN
51,7,Canada,3,3,10,16,1908,CAN
52,8,Norway,2,3,3,8,1908,NOR
53,9,Italy,2,2,0,4,1908,ITA
54,10,Belgium,1,5,2,8,1908,BEL
55,11,Australasia,1,2,2,5,1908,ANZ
56,12,Russia,1,2,0,3,1908,RUS
57,13,Finland,1,1,3,5,1908,FIN
58,14,South Africa,1,1,0,2,1908,RSA
59,15,Greece,0,3,1,4,1908,GRE
60,16,Denmark,0,2,3,5,1908,DEN
61,17,Bohemia,0,0,2,2,1908,BOH
62,17,Netherlands,0,0,2,2,1908,NED
63,19,Austria,0,0,1,1,1908,AUT
64,1,United States,26,19,19,64,1912,USA
65,2,Sweden,23,25,17,65,1912,SWE
66,3,Great Britain,10,15,16,41,1912,GBR
67,4,Finland,9,8,9,26,1912,FIN
68,5,France,7,4,3,14,1912,FRA
69,6,Germany,5,13,7,25,1912,GER
70,7,South Africa,4,2,0,6,1912,RSA
71,8,Norway,3,2,5,10,1912,NOR
72,9,Canada,3,2,3,8,1912,CAN
73,9,Hungary,3,2,3,8,1912,HUN
74,11,Italy,3,1,2,6,1912,ITA
75,12,Australasia,2,2,3,7,1912,ANZ
76,13,Belgium,2,1,3,6,1912,BEL
77,14,Denmark,1,6,5,12,1912,DEN
78,15,Greece,1,0,1,2,1912,GRE
79,16,Russia,0,2,3,5,1912,RUS
80,17,Austria,0,2,2,4,1912,AUT
81,18,Netherlands,0,0,3,3,1912,NED
82,1,United States,41,27,27,95,1920,USA
83,2,Sweden,19,20,25,64,1920,SWE
84,3,Finland,15,10,9,34,1920,FIN
85,4,Great Britain,14,15,13,42,1920,GBR
86,5,Belgium,14,11,11,36,1920,BEL
87,6,Norway,13,9,9,31,1920,NOR
88,7,Italy,13,5,5,23,1920,ITA
89,8,France,9,19,13,41,1920,FRA
90,9,Netherlands,4,2,5,11,1920,NED
91,10,Denmark,3,9,1,13,1920,DEN
92,11,South Africa,3,4,3,10,1920,RSA
93,12,Canada,3,3,3,9,1920,CAN
94,13,Switzerland,2,2,7,11,1920,SUI
95,14,Estonia,1,2,0,3,1920,EST
96,15,Brazil,1,1,1,3,1920,BRA
97,16,Australia,0,2,1,3,1920,AUS
98,17,Japan,0,2,0,2,1920,JPN
99,17,Spain,0,2,0,2,1920,ESP
100,19,Greece,0,1,0,1,1920,GRE
101,19,Luxembourg,0,1,0,1,1920,LUX
102,21,Czechoslovakia,0,0,2,2,1920,TCH
103,22,New Zealand,0,0,1,1,1920,NZL
104,1,United States,45,27,27,99,1924,USA
105,2,Finland,14,13,10,37,1924,FIN
106,3,France,13,15,10,38,1924,FRA
107,4,Great Britain,9,13,12,34,1924,GBR
108,5,Italy,8,3,5,16,1924,ITA
109,6,Switzerland,7,8,10,25,1924,SUI
110,7,Norway,5,2,3,10,1924,NOR
111,8,Sweden,4,13,12,29,1924,SWE
112,9,Netherlands,4,1,5,10,1924,NED
113,10,Belgium,3,7,3,13,1924,BEL
114,11,Australia,3,1,2,6,1924,AUS
115,12,Denmark,2,5,2,9,1924,DEN
116,13,Hungary,2,3,4,9,1924,HUN
117,14,Yugoslavia,2,0,0,2,1924,YUG
118,15,Czechoslovakia,1,4,5,10,1924,TCH
119,16,Argentina,1,3,2,6,1924,ARG
120,17,Estonia,1,1,4,6,1924,EST
121,18,South Africa,1,1,1,3,1924,RSA
122,19,Uruguay,1,0,0,1,1924,URU
123,20,Austria,0,3,1,4,1924,AUT
124,20,Canada,0,3,1,4,1924,CAN
125,22,Poland,0,1,1,2,1924,POL
126,23,Haiti,0,0,1,1,1924,HAI
127,23,Japan,0,0,1,1,1924,JPN
128,23,New Zealand,0,0,1,1,1924,NZL
129,23,Portugal,0,0,1,1,1924,POR
130,23,Romania,0,0,1,1,1924,ROU
131,1,United States,22,18,16,56,1928,USA
132,2,Germany,10,7,14,31,1928,GER
133,3,Finland,8,8,9,25,1928,FIN
134,4,Sweden,7,6,12,25,1928,SWE
135,5,Italy,7,5,7,19,1928,ITA
136,6,Switzerland,7,4,4,15,1928,SUI
137,7,France,6,10,5,21,1928,FRA
138,8,Netherlands,6,9,4,19,1928,NED
139,9,Hungary,4,5,0,9,1928,HUN
140,10,Canada,4,4,7,15,1928,CAN
141,11,Great Britain,3,10,7,20,1928,GBR
142,12,Argentina,3,3,1,7,1928,ARG
143,13,Denmark,3,1,2,6,1928,DEN
144,14,Czechoslovakia,2,5,2,9,1928,TCH
145,15,Japan,2,2,1,5,1928,JPN
146,16,Estonia,2,1,2,5,1928,EST
147,17,Egypt,2,1,1,4,1928,EGY
148,18,Austria,2,0,1,3,1928,AUT
149,19,Australia,1,2,1,4,1928,AUS
150,19,Norway,1,2,1,4,1928,NOR
151,21,Poland,1,1,3,5,1928,POL
152,21,Yugoslavia,1,1,3,5,1928,YUG
153,23,South Africa,1,0,2,3,1928,RSA
154,24,India,1,0,0,1,1928,IND
155,24,Ireland,1,0,0,1,1928,IRL
156,24,New Zealand,1,0,0,1,1928,NZL
157,24,Spain,1,0,0,1,1928,ESP
158,24,Uruguay,1,0,0,1,1928,URU
159,29,Belgium,0,1,2,3,1928,BEL
160,30,Chile,0,1,0,1,1928,CHI
161,30,Haiti,0,1,0,1,1928,HAI
162,32,Philippines,0,0,1,1,1928,PHI
163,32,Portugal,0,0,1,1,1928,POR
164,1,United States,44,36,30,110,1932,USA
165,2,Italy,12,12,12,36,1932,ITA
166,3,France,11,5,4,20,1932,FRA
167,4,Sweden,10,5,9,24,1932,SWE
168,5,Japan,7,7,4,18,1932,JPN
169,6,Hungary,6,5,5,16,1932,HUN
170,7,Germany,5,12,7,24,1932,GER
171,8,Finland,5,8,12,25,1932,FIN
172,9,Great Britain,5,7,5,17,1932,GBR
173,10,Poland,3,2,4,9,1932,POL
174,11,Australia,3,1,1,5,1932,AUS
175,12,Argentina,3,1,0,4,1932,ARG
176,13,Canada,2,5,9,16,1932,CAN
177,14,Netherlands,2,5,1,8,1932,NED
178,15,South Africa,2,0,3,5,1932,RSA
179,16,Ireland,2,0,0,2,1932,IRL
180,17,Czechoslovakia,1,3,2,6,1932,TCH
181,18,Austria,1,1,3,5,1932,AUT
182,19,India,1,0,0,1,1932,IND
183,20,Denmark,0,5,3,8,1932,DEN
184,21,Mexico,0,2,0,2,1932,MEX
185,22,Latvia,0,1,0,1,1932,LAT
186,22,New Zealand,0,1,0,1,1932,NZL
187,22,Switzerland,0,1,0,1,1932,SUI
188,25,Philippines,0,0,3,3,1932,PHI
189,26,Belgium,0,0,1,1,1932,BEL
190,26,Spain,0,0,1,1,1932,ESP
191,26,Uruguay,0,0,1,1,1932,URU
192,1,Germany,38,31,32,101,1936,GER
193,2,United States,24,21,12,57,1936,USA
194,3,Hungary,10,1,5,16,1936,HUN
195,4,Italy,9,13,5,27,1936,ITA
196,5,Finland,8,6,6,20,1936,FIN
197,6,France,7,6,6,19,1936,FRA
198,7,Sweden,6,5,10,21,1936,SWE
199,8,Japan,6,4,10,20,1936,JPN
200,9,Netherlands,6,4,7,17,1936,NED
201,10,Austria,5,7,5,17,1936,AUT
202,11,Switzerland,4,9,5,18,1936,SUI
203,12,Great Britain,4,7,3,14,1936,GBR
204,13,Czechoslovakia,3,5,1,9,1936,TCH
205,14,Argentina,2,2,3,7,1936,ARG
206,14,Estonia,2,2,3,7,1936,EST
207,16,Egypt,2,1,2,5,1936,EGY
208,17,Canada,1,3,5,9,1936,CAN
209,18,Norway,1,3,2,6,1936,NOR
210,19,Turkey,1,0,1,2,1936,TUR
211,20,India,1,0,0,1,1936,IND
212,20,New Zealand,1,0,0,1,1936,NZL
213,22,Poland,0,4,5,9,1936,POL
214,23,Denmark,0,2,3,5,1936,DEN
215,24,Latvia,0,1,1,2,1936,LAT
216,25,Romania,0,1,0,1,1936,ROU
217,25,South Africa,0,1,0,1,1936,RSA
218,25,Yugoslavia,0,1,0,1,1936,YUG
219,28,Belgium,0,0,3,3,1936,BEL
220,28,Mexico,0,0,3,3,1936,MEX
221,30,Australia,0,0,1,1,1936,AUS
222,30,Philippines,0,0,1,1,1936,PHI
223,30,Portugal,0,0,1,1,1936,POR
224,1,United States,38,27,19,84,1948,USA
225,2,Sweden,16,11,17,44,1948,SWE
226,3,France,10,6,13,29,1948,FRA
227,4,Hungary,10,5,12,27,1948,HUN
228,5,Italy,8,11,8,27,1948,ITA
229,6,Finland,8,7,5,20,1948,FIN
230,7,Turkey,6,4,2,12,1948,TUR
231,8,Czechoslovakia,6,2,3,11,1948,TCH
232,9,Switzerland,5,10,5,20,1948,SUI
233,10,Denmark,5,7,8,20,1948,DEN
234,11,Netherlands,5,2,9,16,1948,NED
235,12,Great Britain,3,14,6,23,1948,GBR
236,13,Argentina,3,3,1,7,1948,ARG
237,14,Australia,2,6,5,13,1948,AUS
238,15,Belgium,2,2,3,7,1948,BEL
239,16,Egypt,2,2,1,5,1948,EGY
240,17,Mexico,2,1,2,5,1948,MEX
241,18,South Africa,2,1,1,4,1948,RSA
242,19,Norway,1,3,3,7,1948,NOR
243,20,Jamaica,1,2,0,3,1948,JAM
244,21,Austria,1,0,3,4,1948,AUT
245,22,India,1,0,0,1,1948,IND
246,22,Peru,1,0,0,1,1948,PER
247,24,Yugoslavia,0,2,0,2,1948,YUG
248,25,Canada,0,1,2,3,1948,CAN
249,26,Portugal,0,1,1,2,1948,POR
250,26,Uruguay,0,1,1,2,1948,URU
251,28,Sri Lanka,0,1,0,1,1948,SRI
252,28,Cuba,0,1,0,1,1948,CUB
253,28,Spain,0,1,0,1,1948,ESP
254,28,Trinidad and Tobago,0,1,0,1,1948,TTO
255,32,Panama,0,0,2,2,1948,PAN
256,32,Korea,0,0,2,2,1948,KOR
257,34,Brazil,0,0,1,1,1948,BRA
258,34,Iran,0,0,1,1,1948,IRI
259,34,Poland,0,0,1,1,1948,POL
260,34,Puerto Rico,0,0,1,1,1948,PUR
261,1,United States,40,19,17,76,1952,USA
262,2,Soviet Union,22,30,19,71,1952,URS
263,3,Hungary,16,10,16,42,1952,HUN
264,4,Sweden,12,13,10,35,1952,SWE
265,5,Italy,8,9,4,21,1952,ITA
266,6,Czechoslovakia,7,3,3,13,1952,TCH
267,7,France,6,6,6,18,1952,FRA
268,8,Finland,6,3,13,22,1952,FIN
269,9,Australia,6,2,3,11,1952,AUS
270,10,Norway,3,2,0,5,1952,NOR
271,11,Switzerland,2,6,6,14,1952,SUI
272,12,South Africa,2,4,4,10,1952,RSA
273,13,Jamaica,2,3,0,5,1952,JAM
274,14,Belgium,2,2,0,4,1952,BEL
275,15,Denmark,2,1,3,6,1952,DEN
276,16,Turkey,2,0,1,3,1952,TUR
277,17,Japan,1,6,2,9,1952,JPN
278,18,Great Britain,1,2,8,11,1952,GBR
279,19,Argentina,1,2,2,5,1952,ARG
280,20,Poland,1,2,1,4,1952,POL
281,21,Canada,1,2,0,3,1952,CAN
282,21,Yugoslavia,1,2,0,3,1952,YUG
283,23,Romania,1,1,2,4,1952,ROU
284,24,Brazil,1,0,2,3,1952,BRA
285,24,New Zealand,1,0,2,3,1952,NZL
286,26,India,1,0,1,2,1952,IND
287,27,Luxembourg,1,0,0,1,1952,LUX
288,28,Germany,0,7,17,24,1952,GER
289,29,Netherlands,0,5,0,5,1952,NED
290,30,Iran,0,3,4,7,1952,IRI
291,31,Chile,0,2,0,2,1952,CHI
292,32,Austria,0,1,1,2,1952,AUT
293,32,Lebanon,0,1,1,2,1952,LBN
294,34,Ireland,0,1,0,1,1952,IRL
295,34,Mexico,0,1,0,1,1952,MEX
296,34,Spain,0,1,0,1,1952,ESP
297,37,Korea,0,0,2,2,1952,KOR
298,37,Trinidad and Tobago,0,0,2,2,1952,TTO
299,37,Uruguay,0,0,2,2,1952,URU
300,40,Bulgaria,0,0,1,1,1952,BUL
301,40,Egypt,0,0,1,1,1952,EGY
302,40,Portugal,0,0,1,1,1952,POR
303,40,Venezuela,0,0,1,1,1952,VEN
304,1,Soviet Union,37,29,32,98,1956,URS
305,2,United States,32,25,17,74,1956,USA
306,3,Australia,13,8,14,35,1956,AUS
307,4,Hungary,9,10,7,26,1956,HUN
308,5,Italy,8,8,9,25,1956,ITA
309,6,Sweden,8,5,6,19,1956,SWE
310,7,Germany,6,13,7,26,1956,GER
311,8,Great Britain,6,7,11,24,1956,GBR
312,9,Romania,5,3,5,13,1956,ROU
313,10,Japan,4,10,5,19,1956,JPN
314,11,France,4,4,6,14,1956,FRA
315,12,Turkey,3,2,2,7,1956,TUR
316,13,Finland,3,1,11,15,1956,FIN
317,14,Iran,2,2,1,5,1956,IRI
318,15,Canada,2,1,3,6,1956,CAN
319,16,New Zealand,2,0,0,2,1956,NZL
320,17,Poland,1,4,4,9,1956,POL
321,18,Czechoslovakia,1,4,1,6,1956,TCH
322,19,Bulgaria,1,3,1,5,1956,BUL
323,20,Denmark,1,2,1,4,1956,DEN
324,21,Ireland,1,1,3,5,1956,IRL
325,22,Norway,1,0,2,3,1956,NOR
326,23,Mexico,1,0,1,2,1956,MEX
327,24,Brazil,1,0,0,1,1956,BRA
328,24,India,1,0,0,1,1956,IND
329,26,Yugoslavia,0,3,0,3,1956,YUG
330,27,Chile,0,2,2,4,1956,CHI
331,28,Belgium,0,2,0,2,1956,BEL
332,29,Argentina,0,1,1,2,1956,ARG
333,29,Korea,0,1,1,2,1956,KOR
334,31,Iceland,0,1,0,1,1956,ISL
335,31,Pakistan,0,1,0,1,1956,PAK
336,33,South Africa,0,0,4,4,1956,RSA
337,34,Austria,0,0,2,2,1956,AUT
338,35,The Bahamas,0,0,1,1,1956,BAH
339,35,Greece,0,0,1,1,1956,GRE
340,35,Switzerland,0,0,1,1,1956,SUI
341,35,Uruguay,0,0,1,1,1956,URU
342,1,Soviet Union,43,29,31,103,1960,URS
343,2,United States,34,21,16,71,1960,USA
344,3,Italy,13,10,13,36,1960,ITA
345,4,Germany,12,19,11,42,1960,GER
346,5,Australia,8,8,6,22,1960,AUS
347,6,Turkey,7,2,0,9,1960,TUR
348,7,Hungary,6,8,7,21,1960,HUN
349,8,Japan,4,7,7,18,1960,JPN
350,9,Poland,4,6,11,21,1960,POL
351,10,Czechoslovakia,3,2,3,8,1960,TCH
352,11,Romania,3,1,6,10,1960,ROU
353,12,Great Britain,2,6,12,20,1960,GBR
354,13,Denmark,2,3,1,6,1960,DEN
355,14,New Zealand,2,0,1,3,1960,NZL
356,15,Bulgaria,1,3,3,7,1960,BUL
357,16,Sweden,1,2,3,6,1960,SWE
358,17,Finland,1,1,3,5,1960,FIN
359,18,Austria,1,1,0,2,1960,AUT
360,18,Yugoslavia,1,1,0,2,1960,YUG
361,20,Pakistan,1,0,1,2,1960,PAK
362,21,Ethiopia,1,0,0,1,1960,ETH
363,21,Greece,1,0,0,1,1960,GRE
364,21,Norway,1,0,0,1,1960,NOR
365,24,Switzerland,0,3,3,6,1960,SUI
366,25,France,0,2,3,5,1960,FRA
367,26,Belgium,0,2,2,4,1960,BEL
368,27,Iran,0,1,3,4,1960,IRI
369,28,Netherlands,0,1,2,3,1960,NED
370,28,South Africa,0,1,2,3,1960,RSA
371,30,Argentina,0,1,1,2,1960,ARG
372,30,Egypt,0,1,1,2,1960,EGY
373,32,Canada,0,1,0,1,1960,CAN
374,32,Chinese Taipei,0,1,0,1,1960,TPE
375,32,Ghana,0,1,0,1,1960,GHA
376,32,India,0,1,0,1,1960,IND
377,32,Morocco,0,1,0,1,1960,MAR
378,32,Portugal,0,1,0,1,1960,POR
379,32,Singapore,0,1,0,1,1960,SGP
380,39,Brazil,0,0,2,2,1960,BRA
381,39,West Indies Federation,0,0,2,2,1960,WIF
382,41,Iraq,0,0,1,1,1960,IRQ
383,41,Mexico,0,0,1,1,1960,MEX
384,41,Spain,0,0,1,1,1960,ESP
385,41,Venezuela,0,0,1,1,1960,VEN
386,1,United States,36,26,28,90,1964,USA
387,2,Soviet Union,30,31,35,96,1964,URS
388,3,Japan,16,5,8,29,1964,JPN
389,4,Germany,10,22,18,50,1964,GER
390,5,Italy,10,10,7,27,1964,ITA
391,6,Hungary,10,7,5,22,1964,HUN
392,7,Poland,7,6,10,23,1964,POL
393,8,Australia,6,2,10,18,1964,AUS
394,9,Czechoslovakia,5,6,3,14,1964,TCH
395,10,Great Britain,4,12,2,18,1964,GBR
396,11,Bulgaria,3,5,2,10,1964,BUL
397,12,Finland,3,0,2,5,1964,FIN
398,12,New Zealand,3,0,2,5,1964,NZL
399,14,Romania,2,4,6,12,1964,ROU
400,15,Netherlands,2,4,4,10,1964,NED
401,16,Turkey,2,3,1,6,1964,TUR
402,17,Sweden,2,2,4,8,1964,SWE
403,18,Denmark,2,1,3,6,1964,DEN
404,19,Yugoslavia,2,1,2,5,1964,YUG
405,20,Belgium,2,0,1,3,1964,BEL
406,21,France,1,8,6,15,1964,FRA
407,22,Canada,1,2,1,4,1964,CAN
408,22,Switzerland,1,2,1,4,1964,SUI
409,24,The Bahamas,1,0,0,1,1964,BAH
410,24,Ethiopia,1,0,0,1,1964,ETH
411,24,India,1,0,0,1,1964,IND
412,27,Korea,0,2,1,3,1964,KOR
413,28,Trinidad and Tobago,0,1,2,3,1964,TTO
414,29,Tunisia,0,1,1,2,1964,TUN
415,30,Argentina,0,1,0,1,1964,ARG
416,30,Cuba,0,1,0,1,1964,CUB
417,30,Pakistan,0,1,0,1,1964,PAK
418,30,Philippines,0,1,0,1,1964,PHI
419,34,Iran,0,0,2,2,1964,IRI
420,35,Brazil,0,0,1,1,1964,BRA
421,35,Ghana,0,0,1,1,1964,GHA
422,35,Ireland,0,0,1,1,1964,IRL
423,35,Kenya,0,0,1,1,1964,KEN
424,35,Mexico,0,0,1,1,1964,MEX
425,35,Nigeria,0,0,1,1,1964,NGR
426,35,Uruguay,0,0,1,1,1964,URU
427,1,United States,45,28,34,107,1968,USA
428,2,Soviet Union,29,32,30,91,1968,URS
429,3,Japan,11,7,7,25,1968,JPN
430,4,Hungary,10,10,12,32,1968,HUN
431,5,East Germany,9,9,7,25,1968,GDR
432,6,France,7,3,5,15,1968,FRA
433,7,Czechoslovakia,7,2,4,13,1968,TCH
434,8,West Germany,5,11,10,26,1968,FRG
435,9,Australia,5,7,5,17,1968,AUS
436,10,Great Britain,5,5,3,13,1968,GBR
437,11,Poland,5,2,11,18,1968,POL
438,12,Romania,4,6,5,15,1968,ROU
439,13,Italy,3,4,9,16,1968,ITA
440,14,Kenya,3,4,2,9,1968,KEN
441,15,Mexico,3,3,3,9,1968,MEX
442,16,Yugoslavia,3,3,2,8,1968,YUG
443,17,Netherlands,3,3,1,7,1968,NED
444,18,Bulgaria,2,4,3,9,1968,BUL
445,19,Iran,2,1,2,5,1968,IRI
446,20,Sweden,2,1,1,4,1968,SWE
447,21,Turkey,2,0,0,2,1968,TUR
448,22,Denmark,1,4,3,8,1968,DEN
449,23,Canada,1,3,1,5,1968,CAN
450,24,Finland,1,2,1,4,1968,FIN
451,25,Ethiopia,1,1,0,2,1968,ETH
452,25,Norway,1,1,0,2,1968,NOR
453,27,New Zealand,1,0,2,3,1968,NZL
454,28,Tunisia,1,0,1,2,1968,TUN
455,29,Pakistan,1,0,0,1,1968,PAK
456,29,Venezuela,1,0,0,1,1968,VEN
457,31,Cuba,0,4,0,4,1968,CUB
458,32,Austria,0,2,2,4,1968,AUT
459,33,Switzerland,0,1,4,5,1968,SUI
460,34,Mongolia,0,1,3,4,1968,MGL
461,35,Brazil,0,1,2,3,1968,BRA
462,36,Belgium,0,1,1,2,1968,BEL
463,36,Korea,0,1,1,2,1968,KOR
464,36,Uganda,0,1,1,2,1968,UGA
465,39,Cameroon,0,1,0,1,1968,CMR
466,39,Jamaica,0,1,0,1,1968,JAM
467,41,Argentina,0,0,2,2,1968,ARG
468,42,Greece,0,0,1,1,1968,GRE
469,42,India,0,0,1,1,1968,IND
470,42,Chinese Taipei,0,0,1,1,1968,TPE
471,1,Soviet Union,50,27,22,99,1972,URS
472,2,United States,33,31,30,94,1972,USA
473,3,East Germany,20,23,23,66,1972,GDR
474,4,West Germany,13,11,16,40,1972,FRG
475,5,Japan,13,8,8,29,1972,JPN
476,6,Australia,8,7,2,17,1972,AUS
477,7,Poland,7,5,9,21,1972,POL
478,8,Hungary,6,13,16,35,1972,HUN
479,9,Bulgaria,6,10,5,21,1972,BUL
480,10,Italy,5,3,10,18,1972,ITA
481,11,Sweden,4,6,6,16,1972,SWE
482,12,Great Britain,4,5,9,18,1972,GBR
483,13,Romania,3,6,7,16,1972,ROU
484,14,Cuba,3,1,4,8,1972,CUB
485,14,Finland,3,1,4,8,1972,FIN
486,16,Netherlands,3,1,1,5,1972,NED
487,17,France,2,4,7,13,1972,FRA
488,18,Czechoslovakia,2,4,2,8,1972,TCH
489,19,Kenya,2,3,4,9,1972,KEN
490,20,Yugoslavia,2,1,2,5,1972,YUG
491,21,Norway,2,1,1,4,1972,NOR
492,22,North Korea,1,1,3,5,1972,PRK
493,23,New Zealand,1,1,1,3,1972,NZL
494,24,Uganda,1,1,0,2,1972,UGA
495,25,Denmark,1,0,0,1,1972,DEN
496,26,Switzerland,0,3,0,3,1972,SUI
497,27,Canada,0,2,3,5,1972,CAN
498,28,Iran,0,2,1,3,1972,IRI
499,29,Belgium,0,2,0,2,1972,BEL
500,29,Greece,0,2,0,2,1972,GRE
501,31,Austria,0,1,2,3,1972,AUT
502,31,Colombia,0,1,2,3,1972,COL
503,33,Argentina,0,1,0,1,1972,ARG
504,33,Lebanon,0,1,0,1,1972,LBN
505,33,Mexico,0,1,0,1,1972,MEX
506,33,Mongolia,0,1,0,1,1972,MGL
507,33,Pakistan,0,1,0,1,1972,PAK
508,33,Korea,0,1,0,1,1972,KOR
509,33,Tunisia,0,1,0,1,1972,TUN
510,33,Turkey,0,1,0,1,1972,TUR
511,41,Brazil,0,0,2,2,1972,BRA
512,41,Ethiopia,0,0,2,2,1972,ETH
513,43,Ghana,0,0,1,1,1972,GHA
514,43,India,0,0,1,1,1972,IND
515,43,Jamaica,0,0,1,1,1972,JAM
516,43,Niger,0,0,1,1,1972,NIG
517,43,Nigeria,0,0,1,1,1972,NGR
518,43,Spain,0,0,1,1,1972,ESP
519,1,Soviet Union,49,41,35,125,1976,URS
520,2,East Germany,40,25,25,90,1976,GDR
521,3,United States,34,35,25,94,1976,USA
522,4,West Germany,10,12,17,39,1976,FRG
523,5,Japan,9,6,10,25,1976,JPN
524,6,Poland,7,6,13,26,1976,POL
525,7,Bulgaria,6,9,7,22,1976,BUL
526,8,Cuba,6,4,3,13,1976,CUB
527,9,Romania,4,9,14,27,1976,ROU
528,10,Hungary,4,5,13,22,1976,HUN
529,11,Finland,4,2,0,6,1976,FIN
530,12,Sweden,4,1,0,5,1976,SWE
531,13,Great Britain,3,5,5,13,1976,GBR
532,14,Italy,2,7,4,13,1976,ITA
533,15,France,2,3,4,9,1976,FRA
534,16,Yugoslavia,2,3,3,8,1976,YUG
535,17,Czechoslovakia,2,2,4,8,1976,TCH
536,18,New Zealand,2,1,1,4,1976,NZL
537,19,Korea,1,1,4,6,1976,KOR
538,20,Switzerland,1,1,2,4,1976,SUI
539,21,Jamaica,1,1,0,2,1976,JAM
540,21,North Korea,1,1,0,2,1976,PRK
541,21,Norway,1,1,0,2,1976,NOR
542,24,Denmark,1,0,2,3,1976,DEN
543,25,Mexico,1,0,1,2,1976,MEX
544,26,Trinidad and Tobago,1,0,0,1,1976,TTO
545,27,Canada,0,5,6,11,1976,CAN
546,28,Belgium,0,3,3,6,1976,BEL
547,29,Netherlands,0,2,3,5,1976,NED
548,30,Portugal,0,2,0,2,1976,POR
549,30,Spain,0,2,0,2,1976,ESP
550,32,Australia,0,1,4,5,1976,AUS
551,33,Iran,0,1,1,2,1976,IRI
552,34,Mongolia,0,1,0,1,1976,MGL
553,34,Venezuela,0,1,0,1,1976,VEN
554,36,Brazil,0,0,2,2,1976,BRA
555,37,Austria,0,0,1,1,1976,AUT
556,37,Bermuda,0,0,1,1,1976,BER
557,37,Pakistan,0,0,1,1,1976,PAK
558,37,Puerto Rico,0,0,1,1,1976,PUR
559,37,Thailand,0,0,1,1,1976,THA
560,1,Soviet Union,80,69,46,195,1980,URS
561,2,East Germany,47,37,42,126,1980,GDR
562,3,Bulgaria,8,16,17,41,1980,BUL
563,4,Cuba,8,7,5,20,1980,CUB
564,5,Italy,8,3,4,15,1980,ITA
565,6,Hungary,7,10,15,32,1980,HUN
566,7,Romania,6,6,13,25,1980,ROU
567,8,France,6,5,3,14,1980,FRA
568,9,Great Britain,5,7,9,21,1980,GBR
569,10,Poland,3,14,15,32,1980,POL
570,11,Sweden,3,3,6,12,1980,SWE
571,12,Finland,3,1,4,8,1980,FIN
572,13,Czechoslovakia,2,3,9,14,1980,TCH
573,14,Yugoslavia,2,3,4,9,1980,YUG
574,15,Australia,2,2,5,9,1980,AUS
575,16,Denmark,2,1,2,5,1980,DEN
576,17,Brazil,2,0,2,4,1980,BRA
577,17,Ethiopia,2,0,2,4,1980,ETH
578,19,Switzerland,2,0,0,2,1980,SUI
579,20,Spain,1,3,2,6,1980,ESP
580,21,Austria,1,2,1,4,1980,AUT
581,22,Greece,1,0,2,3,1980,GRE
582,23,Belgium,1,0,0,1,1980,BEL
583,23,India,1,0,0,1,1980,IND
584,23,Zimbabwe,1,0,0,1,1980,ZIM
585,26,North Korea,0,3,2,5,1980,PRK
586,27,Mongolia,0,2,2,4,1980,MGL
587,28,Tanzania,0,2,0,2,1980,TAN
588,29,Mexico,0,1,3,4,1980,MEX
589,30,Netherlands,0,1,2,3,1980,NED
590,31,Ireland,0,1,1,2,1980,IRL
591,32,Uganda,0,1,0,1,1980,UGA
592,32,Venezuela,0,1,0,1,1980,VEN
593,34,Jamaica,0,0,3,3,1980,JAM
594,35,Guyana,0,0,1,1,1980,GUY
595,35,Lebanon,0,0,1,1,1980,LBN
596,1,United States,83,61,30,174,1984,USA
597,2,Romania,20,16,17,53,1984,ROU
598,3,West Germany,17,19,23,59,1984,FRG
599,4,China,15,8,9,32,1984,CHN
600,5,Italy,14,6,12,32,1984,ITA
601,6,Canada,10,18,16,44,1984,CAN
602,7,Japan,10,8,14,32,1984,JPN
603,8,New Zealand,8,1,2,11,1984,NZL
604,9,Yugoslavia,7,4,7,18,1984,YUG
605,10,Korea,6,6,7,19,1984,KOR
606,11,Great Britain,5,11,21,37,1984,GBR
607,12,France,5,7,16,28,1984,FRA
608,13,Netherlands,5,2,6,13,1984,NED
609,14,Australia,4,8,12,24,1984,AUS
610,15,Finland,4,2,6,12,1984,FIN
611,16,Sweden,2,11,6,19,1984,SWE
612,17,Mexico,2,3,1,6,1984,MEX
613,18,Morocco,2,0,0,2,1984,MAR
614,19,Brazil,1,5,2,8,1984,BRA
615,20,Spain,1,2,2,5,1984,ESP
616,21,Belgium,1,1,2,4,1984,BEL
617,22,Austria,1,1,1,3,1984,AUT
618,23,Kenya,1,0,2,3,1984,KEN
619,23,Portugal,1,0,2,3,1984,POR
620,25,Pakistan,1,0,0,1,1984,PAK
621,26,Switzerland,0,4,4,8,1984,SUI
622,27,Denmark,0,3,3,6,1984,DEN
623,28,Jamaica,0,1,2,3,1984,JAM
624,28,Norway,0,1,2,3,1984,NOR
625,30,Greece,0,1,1,2,1984,GRE
626,30,Nigeria,0,1,1,2,1984,NGR
627,30,Puerto Rico,0,1,1,2,1984,PUR
628,33,Colombia,0,1,0,1,1984,COL
629,33,Egypt,0,1,0,1,1984,EGY
630,33,Ireland,0,1,0,1,1984,IRL
631,33,Ivory Coast,0,1,0,1,1984,CIV
632,33,Peru,0,1,0,1,1984,PER
633,33,Syria,0,1,0,1,1984,SYR
634,33,Thailand,0,1,0,1,1984,THA
635,40,Turkey,0,0,3,3,1984,TUR
636,40,Venezuela,0,0,3,3,1984,VEN
637,42,Algeria,0,0,2,2,1984,ALG
638,43,Cameroon,0,0,1,1,1984,CMR
639,43,Chinese Taipei,0,0,1,1,1984,TPE
640,43,Dominican Republic,0,0,1,1,1984,DOM
641,43,Iceland,0,0,1,1,1984,ISL
642,43,Zambia,0,0,1,1,1984,ZAM
643,1,Soviet Union,55,31,46,132,1988,URS
644,2,East Germany,37,35,30,102,1988,GDR
645,3,United States,36,31,27,94,1988,USA
646,4,Korea,12,10,11,33,1988,KOR
647,5,West Germany,11,14,15,40,1988,FRG
648,6,Hungary,11,6,6,23,1988,HUN
649,7,Bulgaria,10,12,13,35,1988,BUL
650,8,Romania,7,11,6,24,1988,ROU
651,9,France,6,4,6,16,1988,FRA
652,10,Italy,6,4,4,14,1988,ITA
653,11,China,5,11,12,28,1988,CHN
654,12,Great Britain,5,10,9,24,1988,GBR
655,13,Kenya,5,2,2,9,1988,KEN
656,14,Japan,4,3,7,14,1988,JPN
657,15,Australia,3,6,5,14,1988,AUS
658,16,Yugoslavia,3,4,5,12,1988,YUG
659,17,Czechoslovakia,3,3,2,8,1988,TCH
660,18,New Zealand,3,2,8,13,1988,NZL
661,19,Canada,3,2,5,10,1988,CAN
662,20,Poland,2,5,9,16,1988,POL
663,21,Norway,2,3,0,5,1988,NOR
664,22,Netherlands,2,2,5,9,1988,NED
665,23,Denmark,2,1,1,4,1988,DEN
666,24,Brazil,1,2,3,6,1988,BRA
667,25,Finland,1,1,2,4,1988,FIN
668,25,Spain,1,1,2,4,1988,ESP
669,27,Turkey,1,1,0,2,1988,TUR
670,28,Morocco,1,0,2,3,1988,MAR
671,29,Austria,1,0,0,1,1988,AUT
672,29,Portugal,1,0,0,1,1988,POR
673,29,Suriname,1,0,0,1,1988,SUR
674,32,Sweden,0,4,7,11,1988,SWE
675,33,Switzerland,0,2,2,4,1988,SUI
676,34,Jamaica,0,2,0,2,1988,JAM
677,35,Argentina,0,1,1,2,1988,ARG
678,36,Chile,0,1,0,1,1988,CHI
679,36,Costa Rica,0,1,0,1,1988,CRC
680,36,Indonesia,0,1,0,1,1988,INA
681,36,Iran,0,1,0,1,1988,IRI
682,36,Netherlands Antilles,0,1,0,1,1988,AHO
683,36,Peru,0,1,0,1,1988,PER
684,36,Senegal,0,1,0,1,1988,SEN
685,36,United States Virgin Islands,0,1,0,1,1988,ISV
686,44,Belgium,0,0,2,2,1988,BEL
687,44,Mexico,0,0,2,2,1988,MEX
688,46,Colombia,0,0,1,1,1988,COL
689,46,Djibouti,0,0,1,1,1988,DJI
690,46,Greece,0,0,1,1,1988,GRE
691,46,Mongolia,0,0,1,1,1988,MGL
692,46,Pakistan,0,0,1,1,1988,PAK
693,46,Philippines,0,0,1,1,1988,PHI
694,46,Thailand,0,0,1,1,1988,THA
695,1,Unified Team,45,38,29,112,1992,EUN
696,2,United States,37,34,37,108,1992,USA
697,3,Germany,33,21,28,82,1992,GER
698,4,China,16,22,16,54,1992,CHN
699,5,Cuba,14,6,11,31,1992,CUB
700,6,Spain,13,7,2,22,1992,ESP
701,7,Korea,12,5,12,29,1992,KOR
702,8,Hungary,11,12,7,30,1992,HUN
703,9,France,8,5,16,29,1992,FRA
704,10,Australia,7,9,11,27,1992,AUS
705,11,Canada,7,4,7,18,1992,CAN
706,12,Italy,6,5,8,19,1992,ITA
707,13,Great Britain,5,3,12,20,1992,GBR
708,14,Romania,4,6,8,18,1992,ROU
709,15,Czechoslovakia,4,2,1,7,1992,TCH
710,16,North Korea,4,0,5,9,1992,PRK
711,17,Japan,3,8,11,22,1992,JPN
712,18,Bulgaria,3,7,6,16,1992,BUL
713,19,Poland,3,6,10,19,1992,POL
714,20,Netherlands,2,6,7,15,1992,NED
715,21,Kenya,2,4,2,8,1992,KEN
716,22,Norway,2,4,1,7,1992,NOR
717,23,Turkey,2,2,2,6,1992,TUR
718,24,Indonesia,2,2,1,5,1992,INA
719,25,Brazil,2,1,0,3,1992,BRA
720,26,Greece,2,0,0,2,1992,GRE
721,27,Sweden,1,7,4,12,1992,SWE
722,28,New Zealand,1,4,5,10,1992,NZL
723,29,Finland,1,2,2,5,1992,FIN
724,30,Denmark,1,1,4,6,1992,DEN
725,31,Morocco,1,1,1,3,1992,MAR
726,32,Ireland,1,1,0,2,1992,IRL
727,33,Ethiopia,1,0,2,3,1992,ETH
728,34,Algeria,1,0,1,2,1992,ALG
729,34,Estonia,1,0,1,2,1992,EST
730,34,Lithuania,1,0,1,2,1992,LTU
731,37,Switzerland,1,0,0,1,1992,SUI
732,38,Jamaica,0,3,1,4,1992,JAM
733,38,Nigeria,0,3,1,4,1992,NGR
734,40,Latvia,0,2,1,3,1992,LAT
735,41,Austria,0,2,0,2,1992,AUT
736,41,Namibia,0,2,0,2,1992,NAM
737,41,South Africa,0,2,0,2,1992,RSA
738,44,Belgium,0,1,2,3,1992,BEL
739,44,Croatia,0,1,2,3,1992,CRO
740,44,Yugoslavia,0,1,2,3,1992,YUG
741,44,Iran,0,1,2,3,1992,IRI
742,48,Israel,0,1,1,2,1992,ISR
743,49,Chinese Taipei,0,1,0,1,1992,TPE
744,49,Mexico,0,1,0,1,1992,MEX
745,49,Peru,0,1,0,1,1992,PER
746,52,Mongolia,0,0,2,2,1992,MGL
747,52,Slovenia,0,0,2,2,1992,SLO
748,54,Argentina,0,0,1,1,1992,ARG
749,54,The Bahamas,0,0,1,1,1992,BAH
750,54,Colombia,0,0,1,1,1992,COL
751,54,Ghana,0,0,1,1,1992,GHA
752,54,Malaysia,0,0,1,1,1992,MAS
753,54,Pakistan,0,0,1,1,1992,PAK
754,54,Philippines,0,0,1,1,1992,PHI
755,54,Puerto Rico,0,0,1,1,1992,PUR
756,54,Qatar,0,0,1,1,1992,QAT
757,54,Suriname,0,0,1,1,1992,SUR
758,54,Thailand,0,0,1,1,1992,THA
759,1,United States,44,32,25,101,1996,USA
760,2,Russia,26,21,16,63,1996,RUS
761,3,Germany,20,18,27,65,1996,GER
762,4,China,16,22,12,50,1996,CHN
763,5,France,15,7,15,37,1996,FRA
764,6,Italy,13,10,12,35,1996,ITA
765,7,Australia,9,9,23,41,1996,AUS
766,8,Cuba,9,8,8,25,1996,CUB
767,9,Ukraine,9,2,12,23,1996,UKR
768,10,Korea,7,15,5,27,1996,KOR
769,11,Poland,7,5,5,17,1996,POL
770,12,Hungary,7,4,10,21,1996,HUN
771,13,Spain,5,6,6,17,1996,ESP
772,14,Romania,4,7,9,20,1996,ROU
773,15,Netherlands,4,5,10,19,1996,NED
774,16,Greece,4,4,0,8,1996,GRE
775,17,Czechia,4,3,4,11,1996,CZE
776,18,Switzerland,4,3,0,7,1996,SUI
777,19,Denmark,4,1,1,6,1996,DEN
778,19,Turkey,4,1,1,6,1996,TUR
779,21,Canada,3,11,8,22,1996,CAN
780,22,Bulgaria,3,7,5,15,1996,BUL
781,23,Japan,3,6,5,14,1996,JPN
782,24,Kazakhstan,3,4,4,11,1996,KAZ
783,25,Brazil,3,3,9,15,1996,BRA
784,26,New Zealand,3,2,1,6,1996,NZL
785,27,South Africa,3,1,1,5,1996,RSA
786,28,Ireland,3,0,1,4,1996,IRL
787,29,Sweden,2,4,2,8,1996,SWE
788,30,Norway,2,2,3,7,1996,NOR
789,31,Belgium,2,2,2,6,1996,BEL
790,32,Nigeria,2,1,3,6,1996,NGR
791,33,North Korea,2,1,2,5,1996,PRK
792,34,Algeria,2,0,1,3,1996,ALG
793,34,Ethiopia,2,0,1,3,1996,ETH
794,36,Great Britain,1,8,6,15,1996,GBR
795,37,Belarus,1,6,8,15,1996,BLR
796,38,Kenya,1,4,3,8,1996,KEN
797,39,Jamaica,1,3,2,6,1996,JAM
798,40,Finland,1,2,1,4,1996,FIN
799,41,Yugoslavia,1,1,2,4,1996,YUG
800,41,Indonesia,1,1,2,4,1996,INA
801,43,Iran,1,1,1,3,1996,IRI
802,43,Slovakia,1,1,1,3,1996,SVK
803,45,Armenia,1,1,0,2,1996,ARM
804,45,Croatia,1,1,0,2,1996,CRO
805,47,Portugal,1,0,1,2,1996,POR
806,47,Thailand,1,0,1,2,1996,THA
807,49,Burundi,1,0,0,1,1996,BDI
808,49,Costa Rica,1,0,0,1,1996,CRC
809,49,Ecuador,1,0,0,1,1996,ECU
810,49,Hong Kong,1,0,0,1,1996,HKG
811,49,Syria,1,0,0,1,1996,SYR
812,54,Argentina,0,2,1,3,1996,ARG
813,55,Namibia,0,2,0,2,1996,NAM
814,55,Slovenia,0,2,0,2,1996,SLO
815,57,Austria,0,1,2,3,1996,AUT
816,58,Malaysia,0,1,1,2,1996,MAS
817,58,Moldova,0,1,1,2,1996,MDA
818,58,Uzbekistan,0,1,1,2,1996,UZB
819,61,Azerbaijan,0,1,0,1,1996,AZE
820,61,The Bahamas,0,1,0,1,1996,BAH
821,61,Chinese Taipei,0,1,0,1,1996,TPE
822,61,Latvia,0,1,0,1,1996,LAT
823,61,Philippines,0,1,0,1,1996,PHI
824,61,Tonga,0,1,0,1,1996,TGA
825,61,Zambia,0,1,0,1,1996,ZAM
826,68,Georgia,0,0,2,2,1996,GEO
827,68,Morocco,0,0,2,2,1996,MAR
828,68,Trinidad and Tobago,0,0,2,2,1996,TTO
829,71,India,0,0,1,1,1996,IND
830,71,Israel,0,0,1,1,1996,ISR
831,71,Lithuania,0,0,1,1,1996,LTU
832,71,Mexico,0,0,1,1,1996,MEX
833,71,Mongolia,0,0,1,1,1996,MGL
834,71,Mozambique,0,0,1,1,1996,MOZ
835,71,Puerto Rico,0,0,1,1,1996,PUR
836,71,Tunisia,0,0,1,1,1996,TUN
837,71,Uganda,0,0,1,1,1996,UGA
838,1,United States,37,24,32,93,2000,USA
839,2,Russia,32,28,29,89,2000,RUS
840,3,China,28,16,14,58,2000,CHN
841,4,Australia,16,25,17,58,2000,AUS
842,5,Germany,13,17,26,56,2000,GER
843,6,France,13,14,11,38,2000,FRA
844,7,Italy,13,8,13,34,2000,ITA
845,8,Netherlands,12,9,4,25,2000,NED
846,9,Cuba,11,11,7,29,2000,CUB
847,10,Great Britain,11,10,7,28,2000,GBR
848,11,Romania,11,6,9,26,2000,ROU
849,12,Korea,8,10,10,28,2000,KOR
850,13,Hungary,8,6,3,17,2000,HUN
851,14,Poland,6,5,3,14,2000,POL
852,15,Japan,5,8,5,18,2000,JPN
853,16,Bulgaria,5,6,2,13,2000,BUL
854,17,Greece,4,6,3,13,2000,GRE
855,18,Sweden,4,5,3,12,2000,SWE
856,19,Norway,4,3,3,10,2000,NOR
857,20,Ethiopia,4,1,3,8,2000,ETH
858,21,Ukraine,3,10,10,23,2000,UKR
859,22,Kazakhstan,3,4,0,7,2000,KAZ
860,23,Belarus,3,3,11,17,2000,BLR
861,24,Canada,3,3,8,14,2000,CAN
862,25,Spain,3,3,5,11,2000,ESP
863,26,Turkey,3,0,2,5,2000,TUR
864,27,Iran,3,0,1,4,2000,IRI
865,28,Czechia,2,3,3,8,2000,CZE
866,29,Kenya,2,3,2,7,2000,KEN
867,30,Denmark,2,3,1,6,2000,DEN
868,31,Finland,2,1,1,4,2000,FIN
869,32,Austria,2,1,0,3,2000,AUT
870,33,Lithuania,2,0,3,5,2000,LTU
871,34,Azerbaijan,2,0,1,3,2000,AZE
872,34,The Bahamas,2,0,1,3,2000,BAH
873,36,Slovenia,2,0,0,2,2000,SLO
874,37,Switzerland,1,6,2,9,2000,SUI
875,38,Indonesia,1,3,2,6,2000,INA
876,39,Slovakia,1,3,1,5,2000,SVK
877,40,Mexico,1,2,3,6,2000,MEX
878,41,Nigeria,1,2,0,3,2000,NGR
879,42,Algeria,1,1,3,5,2000,ALG
880,43,Uzbekistan,1,1,2,4,2000,UZB
881,44,Yugoslavia,1,1,1,3,2000,YUG
882,44,Latvia,1,1,1,3,2000,LAT
883,46,New Zealand,1,0,3,4,2000,NZL
884,47,Estonia,1,0,2,3,2000,EST
885,47,Thailand,1,0,2,3,2000,THA
886,49,Croatia,1,0,1,2,2000,CRO
887,50,Cameroon,1,0,0,1,2000,CMR
888,50,Colombia,1,0,0,1,2000,COL
889,50,Mozambique,1,0,0,1,2000,MOZ
890,53,Brazil,0,6,6,12,2000,BRA
891,54,Jamaica,0,6,3,9,2000,JAM
892,55,Belgium,0,2,3,5,2000,BEL
893,55,South Africa,0,2,3,5,2000,RSA
894,57,Argentina,0,2,2,4,2000,ARG
895,58,Chinese Taipei,0,1,4,5,2000,TPE
896,58,Morocco,0,1,4,5,2000,MAR
897,60,North Korea,0,1,3,4,2000,PRK
898,61,Moldova,0,1,1,2,2000,MDA
899,61,Saudi Arabia,0,1,1,2,2000,KSA
900,61,Trinidad and Tobago,0,1,1,2,2000,TTO
901,64,Ireland,0,1,0,1,2000,IRL
902,64,Sri Lanka,0,1,0,1,2000,SRI
903,64,Uruguay,0,1,0,1,2000,URU
904,64,Vietnam,0,1,0,1,2000,VIE
905,68,Georgia,0,0,6,6,2000,GEO
906,69,Costa Rica,0,0,2,2,2000,CRC
907,69,Portugal,0,0,2,2,2000,POR
908,71,Armenia,0,0,1,1,2000,ARM
909,71,Barbados,0,0,1,1,2000,BAR
910,71,Chile,0,0,1,1,2000,CHI
911,71,Iceland,0,0,1,1,2000,ISL
912,71,India,0,0,1,1,2000,IND
913,71,Israel,0,0,1,1,2000,ISR
914,71,Kuwait,0,0,1,1,2000,KUW
915,71,Kyrgyzstan,0,0,1,1,2000,KGZ
916,71,North Macedonia,0,0,1,1,2000,MKD
917,71,Qatar,0,0,1,1,2000,QAT
918,1,United States,36,39,26,101,2004,USA
919,2,China,32,17,14,63,2004,CHN
920,3,Russia,28,26,36,90,2004,RUS
921,4,Australia,17,16,17,50,2004,AUS
922,5,Japan,16,9,12,37,2004,JPN
923,6,Germany,13,16,20,49,2004,GER
924,7,France,11,9,13,33,2004,FRA
925,8,Italy,10,11,11,32,2004,ITA
926,9,Korea,9,12,9,30,2004,KOR
927,10,Great Britain,9,9,12,30,2004,GBR
928,11,Cuba,9,7,11,27,2004,CUB
929,12,Hungary,8,6,3,17,2004,HUN
930,13,Ukraine,8,5,9,22,2004,UKR
931,14,Romania,8,5,6,19,2004,ROU
932,15,Greece,6,6,4,16,2004,GRE
933,16,Brazil,5,2,3,10,2004,BRA
934,17,Norway,5,0,1,6,2004,NOR
935,18,Netherlands,4,9,9,22,2004,NED
936,19,Sweden,4,2,1,7,2004,SWE
937,20,Spain,3,11,6,20,2004,ESP
938,21,Canada,3,6,3,12,2004,CAN
939,22,Turkey,3,3,4,10,2004,TUR
940,23,Poland,3,2,5,10,2004,POL
941,24,New Zealand,3,2,0,5,2004,NZL
942,25,Thailand,3,1,4,8,2004,THA
943,26,Belarus,2,5,6,13,2004,BLR
944,27,Austria,2,4,1,7,2004,AUT
945,28,Ethiopia,2,3,2,7,2004,ETH
946,29,Iran,2,2,2,6,2004,IRI
947,29,Slovakia,2,2,2,6,2004,SVK
948,31,Chinese Taipei,2,2,1,5,2004,TPE
949,32,Georgia,2,2,0,4,2004,GEO
950,33,Bulgaria,2,1,9,12,2004,BUL
951,34,Denmark,2,1,5,8,2004,DEN
952,35,Jamaica,2,1,2,5,2004,JAM
953,35,Uzbekistan,2,1,2,5,2004,UZB
954,37,Morocco,2,1,0,3,2004,MAR
955,38,Argentina,2,0,4,6,2004,ARG
956,39,Chile,2,0,1,3,2004,CHI
957,40,Kazakhstan,1,4,3,8,2004,KAZ
958,41,Kenya,1,4,2,7,2004,KEN
959,42,Czechia,1,3,5,9,2004,CZE
960,43,South Africa,1,3,2,6,2004,RSA
961,44,Croatia,1,2,2,5,2004,CRO
962,45,Lithuania,1,2,0,3,2004,LTU
963,46,Egypt,1,1,3,5,2004,EGY
964,46,Switzerland,1,1,3,5,2004,SUI
965,48,Indonesia,1,1,2,4,2004,INA
966,49,Zimbabwe,1,1,1,3,2004,ZIM
967,50,Azerbaijan,1,0,4,5,2004,AZE
968,51,Belgium,1,0,2,3,2004,BEL
969,52,The Bahamas,1,0,1,2,2004,BAH
970,52,Israel,1,0,1,2,2004,ISR
971,54,Cameroon,1,0,0,1,2004,CMR
972,54,Dominican Republic,1,0,0,1,2004,DOM
973,54,United Arab Emirates,1,0,0,1,2004,UAE
974,57,North Korea,0,4,1,5,2004,PRK
975,58,Latvia,0,4,0,4,2004,LAT
976,59,Mexico,0,3,1,4,2004,MEX
977,60,Portugal,0,2,1,3,2004,POR
978,61,Finland,0,2,0,2,2004,FIN
979,61,Serbia and Montenegro,0,2,0,2,2004,SCG
980,63,Slovenia,0,1,3,4,2004,SLO
981,64,Estonia,0,1,2,3,2004,EST
982,65,Hong Kong,0,1,0,1,2004,HKG
983,65,India,0,1,0,1,2004,IND
984,65,Paraguay,0,1,0,1,2004,PAR
985,68,Colombia,0,0,2,2,2004,COL
986,68,Nigeria,0,0,2,2,2004,NGR
987,68,Venezuela,0,0,2,2,2004,VEN
988,71,Eritrea,0,0,1,1,2004,ERI
989,71,Mongolia,0,0,1,1,2004,MGL
990,71,Syria,0,0,1,1,2004,SYR
991,71,Trinidad and Tobago,0,0,1,1,2004,TTO
992,1,China,48,22,30,100,2008,CHN
993,2,United States,36,39,37,112,2008,USA
994,3,Russia,24,13,23,60,2008,RUS
995,4,Great Britain,19,13,19,51,2008,GBR
996,5,Germany,16,11,14,41,2008,GER
997,6,Australia,14,15,17,46,2008,AUS
998,7,Korea,13,11,8,32,2008,KOR
999,8,Japan,9,8,8,25,2008,JPN
1000,9,Italy,8,9,10,27,2008,ITA
1001,10,France,7,16,20,43,2008,FRA
1002,11,Netherlands,7,5,4,16,2008,NED
1003,12,Ukraine,7,4,11,22,2008,UKR
1004,13,Kenya,6,4,6,16,2008,KEN
1005,14,Spain,5,11,3,19,2008,ESP
1006,15,Jamaica,5,4,2,11,2008,JAM
1007,16,Poland,4,5,2,11,2008,POL
1008,17,Ethiopia,4,2,1,7,2008,ETH
1009,18,Romania,4,1,4,9,2008,ROU
1010,19,Cuba,3,10,17,30,2008,CUB
1011,20,Canada,3,9,8,20,2008,CAN
1012,21,Hungary,3,5,2,10,2008,HUN
1013,22,Norway,3,5,1,9,2008,NOR
1014,23,Brazil,3,4,10,17,2008,BRA
1015,24,Belarus,3,4,7,14,2008,BLR
1016,25,Czechia,3,3,1,7,2008,CZE
1017,26,Slovakia,3,3,0,6,2008,SVK
1018,27,New Zealand,3,2,4,9,2008,NZL
1019,28,Georgia,3,2,2,7,2008,GEO
1020,29,Kazakhstan,2,3,4,9,2008,KAZ
1021,30,Denmark,2,2,3,7,2008,DEN
1022,31,North Korea,2,2,2,6,2008,PRK
1023,31,Thailand,2,2,2,6,2008,THA
1024,33,Mongolia,2,2,0,4,2008,MGL
1025,34,Switzerland,2,1,4,7,2008,SUI
1026,35,Argentina,2,0,4,6,2008,ARG
1027,36,Mexico,2,0,2,4,2008,MEX
1028,37,Belgium,2,0,0,2,2008,BEL
1029,38,Zimbabwe,1,3,0,4,2008,ZIM
1030,39,Slovenia,1,2,2,5,2008,SLO
1031,40,Azerbaijan,1,1,4,6,2008,AZE
1032,40,Indonesia,1,1,4,6,2008,INA
1033,42,Bulgaria,1,1,3,5,2008,BUL
1034,42,Turkey,1,1,3,5,2008,TUR
1035,44,Chinese Taipei,1,1,2,4,2008,TPE
1036,44,Finland,1,1,2,4,2008,FIN
1037,46,Latvia,1,1,1,3,2008,LAT
1038,47,Dominican Republic,1,1,0,2,2008,DOM
1039,47,Estonia,1,1,0,2,2008,EST
1040,47,Portugal,1,1,0,2,2008,POR
1041,47,Trinidad and Tobago,1,1,0,2,2008,TTO
1042,51,India,1,0,2,3,2008,IND
1043,52,Iran,1,0,1,2,2008,IRI
1044,53,Cameroon,1,0,0,1,2008,CMR
1045,53,Panama,1,0,0,1,2008,PAN
1046,53,Tunisia,1,0,0,1,2008,TUN
1047,56,Sweden,0,4,1,5,2008,SWE
1048,57,Lithuania,0,3,2,5,2008,LTU
1049,57,Nigeria,0,3,2,5,2008,NGR
1050,59,Croatia,0,2,3,5,2008,CRO
1051,60,Colombia,0,2,1,3,2008,COL
1052,60,Greece,0,2,1,3,2008,GRE
1053,62,Armenia,0,1,4,5,2008,ARM
1054,63,Uzbekistan,0,1,3,4,2008,UZB
1055,64,Austria,0,1,2,3,2008,AUT
1056,64,Ireland,0,1,2,3,2008,IRL
1057,64,Kyrgyzstan,0,1,2,3,2008,KGZ
1058,64,Serbia,0,1,2,3,2008,SRB
1059,68,Algeria,0,1,1,2,2008,ALG
1060,68,The Bahamas,0,1,1,2,2008,BAH
1061,68,Morocco,0,1,1,2,2008,MAR
1062,68,Tajikistan,0,1,1,2,2008,TJK
1063,72,Chile,0,1,0,1,2008,CHI
1064,72,Ecuador,0,1,0,1,2008,ECU
1065,72,Iceland,0,1,0,1,2008,ISL
1066,72,Malaysia,0,1,0,1,2008,MAS
1067,72,Samoa,0,1,0,1,2008,SAM
1068,72,Singapore,0,1,0,1,2008,SGP
1069,72,South Africa,0,1,0,1,2008,RSA
1070,72,Sudan,0,1,0,1,2008,SUD
1071,72,Vietnam,0,1,0,1,2008,VIE
1072,81,Egypt,0,0,2,2,2008,EGY
1073,82,Afghanistan,0,0,1,1,2008,AFG
1074,82,Israel,0,0,1,1,2008,ISR
1075,82,Mauritius,0,0,1,1,2008,MRI
1076,82,Moldova,0,0,1,1,2008,MDA
1077,82,Togo,0,0,1,1,2008,TOG
1078,82,Venezuela,0,0,1,1,2008,VEN
1079,1,United States,48,26,30,104,2012,USA
1080,2,China,39,31,22,92,2012,CHN
1081,3,Great Britain,29,18,18,65,2012,GBR
1082,4,Russia,18,21,26,65,2012,RUS
1083,5,Korea,13,9,9,31,2012,KOR
1084,6,Germany,11,20,13,44,2012,GER
1085,7,France,11,11,13,35,2012,FRA
1086,8,Australia,8,15,12,35,2012,AUS
1087,9,Italy,8,9,11,28,2012,ITA
1088,10,Hungary,8,4,6,18,2012,HUN
1089,11,Japan,7,14,17,38,2012,JPN
1090,12,Iran,7,5,1,13,2012,IRI
1091,13,Netherlands,6,6,8,20,2012,NED
1092,14,New Zealand,6,2,5,13,2012,NZL
1093,15,Ukraine,5,4,10,19,2012,UKR
1094,16,Cuba,5,3,7,15,2012,CUB
1095,17,Spain,4,10,6,20,2012,ESP
1096,18,Jamaica,4,5,4,13,2012,JAM
1097,19,Czechia,4,4,3,11,2012,CZE
1098,20,South Africa,4,1,1,6,2012,RSA
1099,21,North Korea,4,0,2,6,2012,PRK
1100,22,Brazil,3,5,9,17,2012,BRA
1101,23,Kazakhstan,3,2,6,11,2012,KAZ
1102,23,Poland,3,2,6,11,2012,POL
1103,25,Ethiopia,3,2,3,8,2012,ETH
1104,26,Croatia,3,1,2,6,2012,CRO
1105,27,Canada,2,6,10,18,2012,CAN
1106,28,Belarus,2,5,3,10,2012,BLR
1107,29,Kenya,2,4,7,13,2012,KEN
1108,30,Denmark,2,4,3,9,2012,DEN
1109,31,Romania,2,4,1,7,2012,ROU
1110,32,Azerbaijan,2,2,5,9,2012,AZE
1111,33,Switzerland,2,2,0,4,2012,SUI
1112,34,Norway,2,1,1,4,2012,NOR
1113,35,Lithuania,2,0,3,5,2012,LTU
1114,36,Tunisia,2,0,1,3,2012,TUN
1115,37,Sweden,1,4,3,8,2012,SWE
1116,38,Colombia,1,3,5,9,2012,COL
1117,39,Mexico,1,3,4,8,2012,MEX
1118,40,Georgia,1,2,3,6,2012,GEO
1119,41,Ireland,1,1,4,6,2012,IRL
1120,42,Argentina,1,1,2,4,2012,ARG
1121,42,Serbia,1,1,2,4,2012,SRB
1122,42,Slovenia,1,1,2,4,2012,SLO
1123,42,Trinidad and Tobago,1,1,2,4,2012,TTO
1124,46,Turkey,1,1,1,3,2012,TUR
1125,47,Dominican Republic,1,1,0,2,2012,DOM
1126,48,Chinese Taipei,1,0,1,2,2012,TPE
1127,48,Latvia,1,0,1,2,2012,LAT
1128,50,Algeria,1,0,0,1,2012,ALG
1129,50,The Bahamas,1,0,0,1,2012,BAH
1130,50,Bahrain,1,0,0,1,2012,BRN
1131,50,Grenada,1,0,0,1,2012,GRN
1132,50,Uganda,1,0,0,1,2012,UGA
1133,50,Venezuela,1,0,0,1,2012,VEN
1134,56,Egypt,0,3,1,4,2012,EGY
1135,57,India,0,2,4,6,2012,IND
1136,58,Mongolia,0,2,3,5,2012,MGL
1137,59,Thailand,0,2,2,4,2012,THA
1138,60,Bulgaria,0,2,1,3,2012,BUL
1139,60,Finland,0,2,1,3,2012,FIN
1140,60,Indonesia,0,2,1,3,2012,INA
1141,63,Slovakia,0,1,3,4,2012,SVK
1142,64,Belgium,0,1,2,3,2012,BEL
1143,65,Armenia,0,1,1,2,2012,ARM
1144,65,Estonia,0,1,1,2,2012,EST
1145,65,Malaysia,0,1,1,2,2012,MAS
1146,65,Puerto Rico,0,1,1,2,2012,PUR
1147,65,Qatar,0,1,1,2,2012,QAT
1148,70,Botswana,0,1,0,1,2012,BOT
1149,70,Cyprus,0,1,0,1,2012,CYP
1150,70,Gabon,0,1,0,1,2012,GAB
1151,70,Guatemala,0,1,0,1,2012,GUA
1152,70,Montenegro,0,1,0,1,2012,MNE
1153,70,Portugal,0,1,0,1,2012,POR
1154,76,Uzbekistan,0,0,3,3,2012,UZB
1155,77,Greece,0,0,2,2,2012,GRE
1156,77,Singapore,0,0,2,2,2012,SGP
1157,79,Afghanistan,0,0,1,1,2012,AFG
1158,79,Cameroon,0,0,1,1,2012,CMR
1159,79,Hong Kong,0,0,1,1,2012,HKG
1160,79,Kuwait,0,0,1,1,2012,KUW
1161,79,Morocco,0,0,1,1,2012,MAR
1162,79,Saudi Arabia,0,0,1,1,2012,KSA
1163,79,Tajikistan,0,0,1,1,2012,TJK
1164,79,Vietnam,0,0,1,1,2012,VIE
1165,1,United States,46,37,38,121,2016,USA
1166,2,Great Britain,27,23,17,67,2016,GBR
1167,3,China,26,18,26,70,2016,CHN
1168,4,Russia,19,17,20,56,2016,RUS
1169,5,Germany,17,10,15,42,2016,GER
1170,6,Japan,12,8,21,41,2016,JPN
1171,7,France,10,18,14,42,2016,FRA
1172,8,Korea,9,3,9,21,2016,KOR
1173,9,Italy,8,12,8,28,2016,ITA
1174,10,Australia,8,11,10,29,2016,AUS
1175,11,Netherlands,8,7,4,19,2016,NED
1176,12,Hungary,8,3,4,15,2016,HUN
1177,13,Brazil,7,6,6,19,2016,BRA
1178,14,Spain,7,4,6,17,2016,ESP
1179,15,Kenya,6,6,1,13,2016,KEN
1180,16,Jamaica,6,3,2,11,2016,JAM
1181,17,Croatia,5,3,2,10,2016,CRO
1182,18,Cuba,5,2,4,11,2016,CUB
1183,19,New Zealand,4,9,5,18,2016,NZL
1184,20,Canada,4,3,15,22,2016,CAN
1185,21,Uzbekistan,4,2,7,13,2016,UZB
1186,22,Colombia,3,2,3,8,2016,COL
1187,23,Switzerland,3,2,2,7,2016,SUI
1188,24,Iran,3,1,4,8,2016,IRI
1189,25,Greece,3,1,2,6,2016,GRE
1190,26,Argentina,3,1,0,4,2016,ARG
1191,27,Denmark,2,6,7,15,2016,DEN
1192,28,Sweden,2,6,3,11,2016,SWE
1193,29,South Africa,2,6,2,10,2016,RSA
1194,30,Kazakhstan,2,5,10,17,2016,KAZ
1195,31,Ukraine,2,5,4,11,2016,UKR
1196,32,Serbia,2,4,2,8,2016,SRB
1197,33,Poland,2,3,6,11,2016,POL
1198,34,North Korea,2,3,2,7,2016,PRK
1199,35,Belgium,2,2,2,6,2016,BEL
1200,35,Thailand,2,2,2,6,2016,THA
1201,37,Slovakia,2,2,0,4,2016,SVK
1202,38,Georgia,2,1,4,7,2016,GEO
1203,39,Azerbaijan,1,7,10,18,2016,AZE
1204,40,Belarus,1,4,4,9,2016,BLR
1205,41,Turkey,1,3,4,8,2016,TUR
1206,42,Armenia,1,3,0,4,2016,ARM
1207,43,Czechia,1,2,7,10,2016,CZE
1208,44,Ethiopia,1,2,5,8,2016,ETH
1209,45,Slovenia,1,2,1,4,2016,SLO
1210,46,Indonesia,1,2,0,3,2016,INA
1211,47,Romania,1,1,2,4,2016,ROU
1212,48,Bahrain,1,1,0,2,2016,BRN
1213,48,Vietnam,1,1,0,2,2016,VIE
1214,50,Chinese Taipei,1,0,2,3,2016,TPE
1215,51,The Bahamas,1,0,1,2,2016,BAH
1216,51,Independent Olympic Athletes,1,0,1,2,2016,IOA
1217,51,Ivory Coast,1,0,1,2,2016,CIV
1218,54,Fiji,1,0,0,1,2016,FIJ
1219,54,Jordan,1,0,0,1,2016,JOR
1220,54,Kosovo,1,0,0,1,2016,KOS
1221,54,Puerto Rico,1,0,0,1,2016,PUR
1222,54,Singapore,1,0,0,1,2016,SGP
1223,54,Tajikistan,1,0,0,1,2016,TJK
1224,60,Malaysia,0,4,1,5,2016,MAS
1225,61,Mexico,0,3,2,5,2016,MEX
1226,62,Venezuela,0,2,1,3,2016,VEN
1227,63,Algeria,0,2,0,2,2016,ALG
1228,63,Ireland,0,2,0,2,2016,IRL
1229,65,Lithuania,0,1,3,4,2016,LTU
1230,66,Bulgaria,0,1,2,3,2016,BUL
1231,67,India,0,1,1,2,2016,IND
1232,67,Mongolia,0,1,1,2,2016,MGL
1233,69,Burundi,0,1,0,1,2016,BDI
1234,69,Grenada,0,1,0,1,2016,GRN
1235,69,Niger,0,1,0,1,2016,NIG
1236,69,Philippines,0,1,0,1,2016,PHI
1237,69,Qatar,0,1,0,1,2016,QAT
1238,74,Norway,0,0,4,4,2016,NOR
1239,75,Egypt,0,0,3,3,2016,EGY
1240,75,Tunisia,0,0,3,3,2016,TUN
1241,77,Israel,0,0,2,2,2016,ISR
1242,78,Austria,0,0,1,1,2016,AUT
1243,78,Dominican Republic,0,0,1,1,2016,DOM
1244,78,Estonia,0,0,1,1,2016,EST
1245,78,Finland,0,0,1,1,2016,FIN
1246,78,Morocco,0,0,1,1,2016,MAR
1247,78,Nigeria,0,0,1,1,2016,NGR
1248,78,Portugal,0,0,1,1,2016,POR
1249,78,Trinidad and Tobago,0,0,1,1,2016,TTO
1250,78,United Arab Emirates,0,0,1,1,2016,UAE
1251,1,United States,39,41,33,113,2020,USA
1252,2,China,38,32,19,89,2020,CHN
1253,3,Japan,27,14,17,58,2020,JPN
1254,4,Great Britain,22,20,22,64,2020,GBR
1255,5,ROC,20,28,23,71,2020,ROC
1256,6,Australia,17,7,22,46,2020,AUS
1257,7,Netherlands,10,12,14,36,2020,NED
1258,8,France,10,12,11,33,2020,FRA
1259,9,Germany,10,11,16,37,2020,GER
1260,10,Italy,10,10,20,40,2020,ITA
1261,11,Canada,7,7,10,24,2020,CAN
1262,12,Brazil,7,6,8,21,2020,BRA
1263,13,New Zealand,7,6,7,20,2020,NZL
1264,14,Cuba,7,3,5,15,2020,CUB
1265,15,Hungary,6,7,7,20,2020,HUN
1266,16,Korea,6,4,10,20,2020,KOR
1267,17,Poland,4,5,5,14,2020,POL
1268,18,Czechia,4,4,3,11,2020,CZE
1269,19,Kenya,4,4,2,10,2020,KEN
1270,20,Norway,4,2,2,8,2020,NOR
1271,21,Jamaica,4,1,4,9,2020,JAM
1272,22,Spain,3,8,6,17,2020,ESP
1273,23,Sweden,3,6,0,9,2020,SWE
1274,24,Switzerland,3,4,6,13,2020,SUI
1275,25,Denmark,3,4,4,11,2020,DEN
1276,26,Croatia,3,3,2,8,2020,CRO
1277,27,Iran,3,2,2,7,2020,IRI
1278,28,Serbia,3,1,5,9,2020,SRB
1279,29,Belgium,3,1,3,7,2020,BEL
1280,30,Bulgaria,3,1,2,6,2020,BUL
1281,31,Slovenia,3,1,1,5,2020,SLO
1282,32,Uzbekistan,3,0,2,5,2020,UZB
1283,33,Georgia,2,5,1,8,2020,GEO
1284,34,Chinese Taipei,2,4,6,12,2020,TPE
1285,35,Turkey,2,2,9,13,2020,TUR
1286,36,Greece,2,1,1,4,2020,GRE
1287,36,Uganda,2,1,1,4,2020,UGA
1288,38,Ecuador,2,1,0,3,2020,ECU
1289,39,Ireland,2,0,2,4,2020,IRL
1290,39,Israel,2,0,2,4,2020,ISR
1291,41,Qatar,2,0,1,3,2020,QAT
1292,42,The Bahamas,2,0,0,2,2020,BAH
1293,42,Kosovo,2,0,0,2,2020,KOS
1294,44,Ukraine,1,6,12,19,2020,UKR
1295,45,Belarus,1,3,3,7,2020,BLR
1296,46,Romania,1,3,0,4,2020,ROU
1297,46,Venezuela,1,3,0,4,2020,VEN
1298,48,India,1,2,4,7,2020,IND
1299,49,Hong Kong,1,2,3,6,2020,HKG
1300,50,Philippines,1,2,1,4,2020,PHI
1301,50,Slovakia,1,2,1,4,2020,SVK
1302,52,South Africa,1,2,0,3,2020,RSA
1303,53,Austria,1,1,5,7,2020,AUT
1304,54,Egypt,1,1,4,6,2020,EGY
1305,55,Indonesia,1,1,3,5,2020,INA
1306,56,Ethiopia,1,1,2,4,2020,ETH
1307,56,Portugal,1,1,2,4,2020,POR
1308,58,Tunisia,1,1,0,2,2020,TUN
1309,59,Estonia,1,0,1,2,2020,EST
1310,59,Fiji,1,0,1,2,2020,FIJ
1311,59,Latvia,1,0,1,2,2020,LAT
1312,59,Thailand,1,0,1,2,2020,THA
1313,63,Bermuda,1,0,0,1,2020,BER
1314,63,Morocco,1,0,0,1,2020,MAR
1315,63,Puerto Rico,1,0,0,1,2020,PUR
1316,66,Colombia,0,4,1,5,2020,COL
1317,67,Azerbaijan,0,3,4,7,2020,AZE
1318,68,Dominican Republic,0,3,2,5,2020,DOM
1319,69,Armenia,0,2,2,4,2020,ARM
1320,70,Kyrgyzstan,0,2,1,3,2020,KGZ
1321,71,Mongolia,0,1,3,4,2020,MGL
1322,72,Argentina,0,1,2,3,2020,ARG
1323,72,San Marino,0,1,2,3,2020,SMR
1324,74,Jordan,0,1,1,2,2020,JOR
1325,74,Malaysia,0,1,1,2,2020,MAS
1326,74,Nigeria,0,1,1,2,2020,NGR
1327,77,Bahrain,0,1,0,1,2020,BRN
1328,77,Lithuania,0,1,0,1,2020,LTU
1329,77,Namibia,0,1,0,1,2020,NAM
1330,77,North Macedonia,0,1,0,1,2020,MKD
1331,77,Saudi Arabia,0,1,0,1,2020,KSA
1332,77,Turkmenistan,0,1,0,1,2020,TKM
1333,83,Kazakhstan,0,0,8,8,2020,KAZ
1334,84,Mexico,0,0,4,4,2020,MEX
1335,85,Finland,0,0,2,2,2020,FIN
1336,86,Botswana,0,0,1,1,2020,BOT
1337,86,Burkina Faso,0,0,1,1,2020,BUR
1338,86,Ghana,0,0,1,1,2020,GHA
1339,86,Grenada,0,0,1,1,2020,GRN
1340,86,Ivory Coast,0,0,1,1,2020,CIV
1341,86,Kuwait,0,0,1,1,2020,KUW
1342,86,Moldova,0,0,1,1,2020,MDA
1343,86,Syria,0,0,1,1,2020,SYR
1344,1,United States,40,44,42,126,2024,USA
1345,2,China,40,27,24,91,2024,CHN
1346,3,Japan,20,12,13,45,2024,JPN
1347,4,Australia,18,19,16,53,2024,AUS
1348,5,France,16,26,22,64,2024,FRA
1349,6,Netherlands,15,7,12,34,2024,NED
1350,7,Great Britain,14,22,29,65,2024,GBR
1351,8,Korea,13,9,10,32,2024,KOR
1352,9,Italy,12,13,15,40,2024,ITA
1353,10,Germany,12,13,8,33,2024,GER
1354,11,New Zealand,10,7,3,20,2024,NZL
1355,12,Canada,9,7,11,27,2024,CAN
1356,13,Uzbekistan,8,2,3,13,2024,UZB
1357,14,Hungary,6,7,6,19,2024,HUN
1358,15,Spain,5,4,9,18,2024,ESP
1359,16,Sweden,4,4,3,11,2024,SWE
1360,17,Kenya,4,2,5,11,2024,KEN
1361,18,Norway,4,1,3,8,2024,NOR
1362,19,Ireland,4,0,3,7,2024,IRL
1363,20,Brazil,3,7,10,20,2024,BRA
1364,21,Iran,3,6,3,12,2024,IRI
1365,22,Ukraine,3,5,4,12,2024,UKR
1366,23,Romania,3,4,2,9,2024,ROU
1367,24,Georgia,3,3,1,7,2024,GEO
1368,25,Belgium,3,1,6,10,2024,BEL
1369,26,Bulgaria,3,1,3,7,2024,BUL
1370,27,Serbia,3,1,1,5,2024,SRB
1371,28,Czechia,3,0,2,5,2024,CZE
1372,29,Denmark,2,2,5,9,2024,DEN
1373,30,Azerbaijan,2,2,3,7,2024,AZE
1374,30,Croatia,2,2,3,7,2024,CRO
1375,32,Cuba,2,1,6,9,2024,CUB
1376,33,Bahrain,2,1,1,4,2024,BRN
1377,34,Slovenia,2,1,0,3,2024,SLO
1378,35,Chinese Taipei,2,0,5,7,2024,TPE
1379,36,Austria,2,0,3,5,2024,AUT
1380,37,Hong Kong,2,0,2,4,2024,HKG
1381,37,Philippines,2,0,2,4,2024,PHI
1382,39,Algeria,2,0,1,3,2024,ALG
1383,39,Indonesia,2,0,1,3,2024,INA
1384,41,Israel,1,5,1,7,2024,ISR
1385,42,Poland,1,4,5,10,2024,POL
1386,43,Kazakhstan,1,3,3,7,2024,KAZ
1387,44,Jamaica,1,3,2,6,2024,JAM
1388,44,South Africa,1,3,2,6,2024,RSA
1389,44,Thailand,1,3,2,6,2024,THA
1390,47,Ethiopia,1,3,0,4,2024,ETH
1391,48,Switzerland,1,2,5,8,2024,SUI
1392,49,Ecuador,1,2,2,5,2024,ECU
1393,50,Portugal,1,2,1,4,2024,POR
1394,51,Greece,1,1,6,8,2024,GRE
1395,52,Argentina,1,1,1,3,2024,ARG
1396,52,Egypt,1,1,1,3,2024,EGY
1397,52,Tunisia,1,1,1,3,2024,TUN
1398,55,Botswana,1,1,0,2,2024,BOT
1399,55,Chile,1,1,0,2,2024,CHI
1400,55,Saint Lucia,1,1,0,2,2024,LCA
1401,55,Uganda,1,1,0,2,2024,UGA
1402,59,Dominican Republic,1,0,2,3,2024,DOM
1403,60,Guatemala,1,0,1,2,2024,GUA
1404,60,Morocco,1,0,1,2,2024,MAR
1405,62,Dominica,1,0,0,1,2024,DMA
1406,62,Pakistan,1,0,0,1,2024,PAK
1407,64,Turkey,0,3,5,8,2024,TUR
1408,65,Mexico,0,3,2,5,2024,MEX
1409,66,Armenia,0,3,1,4,2024,ARM
1410,66,Colombia,0,3,1,4,2024,COL
1411,68,Kyrgyzstan,0,2,4,6,2024,KGZ
1412,68,North Korea,0,2,4,6,2024,PRK
1413,70,Lithuania,0,2,2,4,2024,LTU
1414,71,India,0,1,5,6,2024,IND
1415,72,Moldova,0,1,3,4,2024,MDA
1416,73,Kosovo,0,1,1,2,2024,KOS
1417,74,Cyprus,0,1,0,1,2024,CYP
1418,74,Fiji,0,1,0,1,2024,FIJ
1419,74,Jordan,0,1,0,1,2024,JOR
1420,74,Mongolia,0,1,0,1,2024,MGL
1421,74,Panama,0,1,0,1,2024,PAN
1422,79,Tajikistan,0,0,3,3,2024,TJK
1423,80,Albania,0,0,2,2,2024,ALB
1424,80,Grenada,0,0,2,2,2024,GRN
1425,80,Malaysia,0,0,2,2,2024,MAS
1426,80,Puerto Rico,0,0,2,2,2024,PUR
1427,84,Cabo Verde,0,0,1,1,2024,CPV
1428,84,Ivory Coast,0,0,1,1,2024,CIV
1429,84,Peru,0,0,1,1,2024,PER
1430,84,Qatar,0,0,1,1,2024,QAT
1431,84,Refugee Olympic Team,0,0,1,1,2024,EOR
1432,84,Singapore,0,0,1,1,2024,SGP
1433,84,Slovakia,0,0,1,1,2024,SVK
1434,84,Zambia,0,0,1,1,2024,ZAM
