,Rank,Country,Gold,Silver,Bronze,Total,Year
0,1,United States,11,7,2,20,1896
1,2,Greece,10,18,19,47,1896
2,3,Germany,6,5,2,13,1896
3,4,France,5,4,2,11,1896
4,5,Great Britain,2,3,2,7,1896
5,6,Hungary,2,1,3,6,1896
6,7,Austria,2,1,2,5,1896
7,8,Australia,2,0,0,2,1896
8,9,Denmark,1,2,3,6,1896
9,10,Switzerland,1,2,0,3,1896
10,11,Mixed team,1,0,1,2,1896
11,1,France,27,39,37,103,1900
12,2,United States,19,14,15,48,1900
13,3,Great Britain,15,7,9,31,1900
14,4,Mixed team,8,5,6,19,1900
15,5,Belgium,6,7,4,17,1900
16,6,Switzerland,6,2,1,9,1900
17,7,Germany,4,3,2,9,1900
18,8,Italy,3,2,0,5,1900
19,9,Australia,2,0,3,5,1900
20,10,Denmark,1,3,2,6,1900
21,11,Hungary,1,2,2,5,1900
22,12,Cuba,1,1,0,2,1900
23,13,Canada,1,0,1,2,1900
24,14,Spain,1,0,0,1,1900
25,14,Luxembourg,1,0,0,1,1900
26,16,Austria,0,3,3,6,1900
27,17,Norway,0,2,3,5,1900
28,17,Netherlands,0,2,3,5,1900
29,19,India,0,2,0,2,1900
30,20,Bohemia,0,1,1,2,1900
31,21,Sweden,0,0,1,1,1900
32,1,United States,76,78,77,231,1904
33,2,Germany,4,5,6,15,1904
34,3,Canada,4,1,1,6,1904
35,4,Cuba,3,0,0,3,1904
36,5,Hungary,2,1,1,4,1904
37,5,Mixed team,2,1,1,4,1904
38,7,Norway,2,0,0,2,1904
39,8,Austria,1,1,1,3,1904
40,9,Great Britain,1,1,0,2,1904
41,10,Switzerland,1,0,2,3,1904
42,11,Greece,1,0,1,2,1904
43,12,Australia,0,3,1,4,1904
44,13,France,0,1,0,1,1904
45,1,Great Britain,56,51,39,146,1908
46,2,United States,23,12,12,47,1908
47,3,Sweden,8,6,11,25,1908
48,4,France,5,5,9,19,1908
49,5,Germany,3,5,5,13,1908
50,6,Hungary,3,4,2,9,1908
51,7,Canada,3,3,10,16,1908
52,8,Norway,2,3,3,8,1908
53,9,Italy,2,2,0,4,1908
54,10,Belgium,1,5,2,8,1908
55,11,Australasia,1,2,2,5,1908
56,12,Russia,1,2,0,3,1908
57,13,Finland,1,1,3,5,1908
58,14,South Africa,1,1,0,2,1908
59,15,Greece,0,3,1,4,1908
60,16,Denmark,0,2,3,5,1908
61,17,Bohemia,0,0,2,2,1908
62,17,Netherlands,0,0,2,2,1908
63,19,Austria,0,0,1,1,1908
64,1,United States,26,19,19,64,1912
65,2,Sweden,23,25,17,65,1912
66,3,Great Britain,10,15,16,41,1912
67,4,Finland,9,8,9,26,1912
68,5,France,7,4,3,14,1912
69,6,Germany,5,13,7,25,1912
70,7,South Africa,4,2,0,6,1912
71,8,Norway,3,2,5,10,1912
72,9,Canada,3,2,3,8,1912
73,9,Hungary,3,2,3,8,1912
74,11,Italy,3,1,2,6,1912
75,12,Australasia,2,2,3,7,1912
76,13,Belgium,2,1,3,6,1912
77,14,Denmark,1,6,5,12,1912
78,15,Greece,1,0,1,2,1912
79,16,Russia,0,2,3,5,1912
80,17,Austria,0,2,2,4,1912
81,18,Netherlands,0,0,3,3,1912
82,1,United States,41,27,27,95,1920
83,2,Sweden,19,20,25,64,1920
84,3,Finland,15,10,9,34,1920
85,4,Great Britain,14,15,13,42,1920
86,5,Belgium,14,11,11,36,1920
87,6,Norway,13,9,9,31,1920
88,7,Italy,13,5,5,23,1920
89,8,France,9,19,13,41,1920
90,9,Netherlands,4,2,5,11,1920
91,10,Denmark,3,9,1,13,1920
92,11,South Africa,3,4,3,10,1920
93,12,Canada,3,3,3,9,1920
94,13,Switzerland,2,2,7,11,1920
95,14,Estonia,1,2,0,3,1920
96,15,Brazil,1,1,1,3,1920
97,16,Australia,0,2,1,3,1920
98,17,Japan,0,2,0,2,1920
99,17,Spain,0,2,0,2,1920
100,19,Greece,0,1,0,1,1920
101,19,Luxembourg,0,1,0,1,1920
102,21,Czechoslovakia,0,0,2,2,1920
103,22,New Zealand,0,0,1,1,1920
104,1,United States,45,27,27,99,1924
105,2,Finland,14,13,10,37,1924
106,3,France,13,15,10,38,1924
107,4,Great Britain,9,13,12,34,1924
108,5,Italy,8,3,5,16,1924
109,6,Switzerland,7,8,10,25,1924
110,7,Norway,5,2,3,10,1924
111,8,Sweden,4,13,12,29,1924
112,9,Netherlands,4,1,5,10,1924
113,10,Belgium,3,7,3,13,1924
114,11,Australia,3,1,2,6,1924
115,12,Denmark,2,5,2,9,1924
116,13,Hungary,2,3,4,9,1924
117,14,Yugoslavia,2,0,0,2,1924
118,15,Czechoslovakia,1,4,5,10,1924
119,16,Argentina,1,3,2,6,1924
120,17,Estonia,1,1,4,6,1924
121,18,South Africa,1,1,1,3,1924
122,19,Uruguay,1,0,0,1,1924
123,20,Austria,0,3,1,4,1924
124,20,Canada,0,3,1,4,1924
125,22,Poland,0,1,1,2,1924
126,23,Haiti,0,0,1,1,1924
127,23,Japan,0,0,1,1,1924
128,23,New Zealand,0,0,1,1,1924
129,23,Portugal,0,0,1,1,1924
130,23,Romania,0,0,1,1,1924
131,1,United States,22,18,16,56,1928
132,2,Germany,10,7,14,31,1928
133,3,Finland,8,8,9,25,1928
134,4,Sweden,7,6,12,25,1928
135,5,Italy,7,5,7,19,1928
136,6,Switzerland,7,4,4,15,1928
137,7,France,6,10,5,21,1928
138,8,Netherlands,6,9,4,19,1928
139,9,Hungary,4,5,0,9,1928
140,10,Canada,4,4,7,15,1928
141,11,Great Britain,3,10,7,20,1928
142,12,Argentina,3,3,1,7,1928
143,13,Denmark,3,1,2,6,1928
144,14,Czechoslovakia,2,5,2,9,1928
145,15,Japan,2,2,1,5,1928
146,16,Estonia,2,1,2,5,1928
147,17,Egypt,2,1,1,4,1928
148,18,Austria,2,0,1,3,1928
149,19,Australia,1,2,1,4,1928
150,19,Norway,1,2,1,4,1928
151,21,Poland,1,1,3,5,1928
152,21,Yugoslavia,1,1,3,5,1928
153,23,South Africa,1,0,2,3,1928
154,24,India,1,0,0,1,1928
155,24,Ireland,1,0,0,1,1928
156,24,New Zealand,1,0,0,1,1928
157,24,Spain,1,0,0,1,1928
158,24,Uruguay,1,0,0,1,1928
159,29,Belgium,0,1,2,3,1928
160,30,Chile,0,1,0,1,1928
161,30,Haiti,0,1,0,1,1928
162,32,Philippines,0,0,1,1,1928
163,32,Portugal,0,0,1,1,1928
164,1,United States,44,36,30,110,1932
165,2,Italy,12,12,12,36,1932
166,3,France,11,5,4,20,1932
167,4,Sweden,10,5,9,24,1932
168,5,Japan,7,7,4,18,1932
169,6,Hungary,6,5,5,16,1932
170,7,Germany,5,12,7,24,1932
171,8,Finland,5,8,12,25,1932
172,9,Great Britain,5,7,5,17,1932
173,10,Poland,3,2,4,9,1932
174,11,Australia,3,1,1,5,1932
175,12,Argentina,3,1,0,4,1932
176,13,Canada,2,5,9,16,1932
177,14,Netherlands,2,5,1,8,1932
178,15,South Africa,2,0,3,5,1932
179,16,Ireland,2,0,0,2,1932
180,17,Czechoslovakia,1,3,2,6,1932
181,18,Austria,1,1,3,5,1932
182,19,India,1,0,0,1,1932
183,20,Denmark,0,5,3,8,1932
184,21,Mexico,0,2,0,2,1932
185,22,Latvia,0,1,0,1,1932
186,22,New Zealand,0,1,0,1,1932
187,22,Switzerland,0,1,0,1,1932
188,25,Philippines,0,0,3,3,1932
189,26,Belgium,0,0,1,1,1932
190,26,Spain,0,0,1,1,1932
191,26,Uruguay,0,0,1,1,1932
192,1,Germany,38,31,32,101,1936
193,2,United States,24,21,12,57,1936
194,3,Hungary,10,1,5,16,1936
195,4,Italy,9,13,5,27,1936
196,5,Finland,8,6,6,20,1936
197,6,France,7,6,6,19,1936
198,7,Sweden,6,5,10,21,1936
199,8,Japan,6,4,10,20,1936
200,9,Netherlands,6,4,7,17,1936
201,10,Austria,5,7,5,17,1936
202,11,Switzerland,4,9,5,18,1936
203,12,Great Britain,4,7,3,14,1936
204,13,Czechoslovakia,3,5,1,9,1936
205,14,Argentina,2,2,3,7,1936
206,14,Estonia,2,2,3,7,1936
207,16,Egypt,2,1,2,5,1936
208,17,Canada,1,3,5,9,1936
209,18,Norway,1,3,2,6,1936
210,19,Turkey,1,0,1,2,1936
211,20,India,1,0,0,1,1936
212,20,New Zealand,1,0,0,1,1936
213,22,Poland,0,4,5,9,1936
214,23,Denmark,0,2,3,5,1936
215,24,Latvia,0,1,1,2,1936
216,25,Romania,0,1,0,1,1936
217,25,South Africa,0,1,0,1,1936
218,25,Yugoslavia,0,1,0,1,1936
219,28,Belgium,0,0,3,3,1936
220,28,Mexico,0,0,3,3,1936
221,30,Australia,0,0,1,1,1936
222,30,Philippines,0,0,1,1,1936
223,30,Portugal,0,0,1,1,1936
224,1,United States,38,27,19,84,1948
225,2,Sweden,16,11,17,44,1948
226,3,France,10,6,13,29,1948
227,4,Hungary,10,5,12,27,1948
228,5,Italy,8,11,8,27,1948
229,6,Finland,8,7,5,20,1948
230,7,Turkey,6,4,2,12,1948
231,8,Czechoslovakia,6,2,3,11,1948
232,9,Switzerland,5,10,5,20,1948
233,10,Denmark,5,7,8,20,1948
234,11,Netherlands,5,2,9,16,1948
235,12,Great Britain,3,14,6,23,1948
236,13,Argentina,3,3,1,7,1948
237,14,Australia,2,6,5,13,1948
238,15,Belgium,2,2,3,7,1948
239,16,Egypt,2,2,1,5,1948
240,17,Mexico,2,1,2,5,1948
241,18,South Africa,2,1,1,4,1948
242,19,Norway,1,3,3,7,1948
243,20,Jamaica,1,2,0,3,1948
244,21,Austria,1,0,3,4,1948
245,22,India,1,0,0,1,1948
246,22,Peru,1,0,0,1,1948
247,24,Yugoslavia,0,2,0,2,1948
248,25,Canada,0,1,2,3,1948
249,26,Portugal,0,1,1,2,1948
250,26,Uruguay,0,1,1,2,1948
251,28,Sri Lanka,0,1,0,1,1948
252,28,Cuba,0,1,0,1,1948
253,28,Spain,0,1,0,1,1948
254,28,Trinidad and Tobago,0,1,0,1,1948
255,32,Panama,0,0,2,2,1948
256,32,Korea,0,0,2,2,1948
257,34,Brazil,0,0,1,1,1948
258,34,Iran,0,0,1,1,1948
259,34,Poland,0,0,1,1,1948
260,34,Puerto Rico,0,0,1,1,1948
261,1,United States,40,19,17,76,1952
262,2,Soviet Union,22,30,19,71,1952
263,3,Hungary,16,10,16,42,1952
264,4,Sweden,12,13,10,35,1952
265,5,Italy,8,9,4,21,1952
266,6,Czechoslovakia,7,3,3,13,1952
267,7,France,6,6,6,18,1952
268,8,Finland,6,3,13,22,1952
269,9,Australia,6,2,3,11,1952
270,10,Norway,3,2,0,5,1952
271,11,Switzerland,2,6,6,14,1952
272,12,South Africa,2,4,4,10,1952
273,13,Jamaica,2,3,0,5,1952
274,14,Belgium,2,2,0,4,1952
275,15,Denmark,2,1,3,6,1952
276,16,Turkey,2,0,1,3,1952
277,17,Japan,1,6,2,9,1952
278,18,Great Britain,1,2,8,11,1952
279,19,Argentina,1,2,2,5,1952
280,20,Poland,1,2,1,4,1952
281,21,Canada,1,2,0,3,1952
282,21,Yugoslavia,1,2,0,3,1952
283,23,Romania,1,1,2,4,1952
284,24,Brazil,1,0,2,3,1952
285,24,New Zealand,1,0,2,3,1952
286,26,India,1,0,1,2,1952
287,27,Luxembourg,1,0,0,1,1952
288,28,Germany,0,7,17,24,1952
289,29,Netherlands,0,5,0,5,1952
290,30,Iran,0,3,4,7,1952
291,31,Chile,0,2,0,2,1952
292,32,Austria,0,1,1,2,1952
293,32,Lebanon,0,1,1,2,1952
294,34,Ireland,0,1,0,1,1952
295,34,Mexico,0,1,0,1,1952
296,34,Spain,0,1,0,1,1952
297,37,Korea,0,0,2,2,1952
298,37,Trinidad and Tobago,0,0,2,2,1952
299,37,Uruguay,0,0,2,2,1952
300,40,Bulgaria,0,0,1,1,1952
301,40,Egypt,0,0,1,1,1952
302,40,Portugal,0,0,1,1,1952
303,40,Venezuela,0,0,1,1,1952
304,1,Soviet Union,37,29,32,98,1956
305,2,United States,32,25,17,74,1956
306,3,Australia,13,8,14,35,1956
307,4,Hungary,9,10,7,26,1956
308,5,Italy,8,8,9,25,1956
309,6,Sweden,8,5,6,19,1956
310,7,Germany,6,13,7,26,1956
311,8,Great Britain,6,7,11,24,1956
312,9,Romania,5,3,5,13,1956
313,10,Japan,4,10,5,19,1956
314,11,France,4,4,6,14,1956
315,12,Turkey,3,2,2,7,1956
316,13,Finland,3,1,11,15,1956
317,14,Iran,2,2,1,5,1956
318,15,Canada,2,1,3,6,1956
319,16,New Zealand,2,0,0,2,1956
320,17,Poland,1,4,4,9,1956
321,18,Czechoslovakia,1,4,1,6,1956
322,19,Bulgaria,1,3,1,5,1956
323,20,Denmark,1,2,1,4,1956
324,21,Ireland,1,1,3,5,1956
325,22,Norway,1,0,2,3,1956
326,23,Mexico,1,0,1,2,1956
327,24,Brazil,1,0,0,1,1956
328,24,India,1,0,0,1,1956
329,26,Yugoslavia,0,3,0,3,1956
330,27,Chile,0,2,2,4,1956
331,28,Belgium,0,2,0,2,1956
332,29,Argentina,0,1,1,2,1956
333,29,Korea,0,1,1,2,1956
334,31,Iceland,0,1,0,1,1956
335,31,Pakistan,0,1,0,1,1956
336,33,South Africa,0,0,4,4,1956
337,34,Austria,0,0,2,2,1956
338,35,The Bahamas,0,0,1,1,1956
339,35,Greece,0,0,1,1,1956
340,35,Switzerland,0,0,1,1,1956
341,35,Uruguay,0,0,1,1,1956
342,1,Soviet Union,43,29,31,103,1960
343,2,United States,34,21,16,71,1960
344,3,Italy,13,10,13,36,1960
345,4,Germany,12,19,11,42,1960
346,5,Australia,8,8,6,22,1960
347,6,Turkey,7,2,0,9,1960
348,7,Hungary,6,8,7,21,1960
349,8,Japan,4,7,7,18,1960
350,9,Poland,4,6,11,21,1960
351,10,Czechoslovakia,3,2,3,8,1960
352,11,Romania,3,1,6,10,1960
353,12,Great Britain,2,6,12,20,1960
354,13,Denmark,2,3,1,6,1960
355,14,New Zealand,2,0,1,3,1960
356,15,Bulgaria,1,3,3,7,1960
357,16,Sweden,1,2,3,6,1960
358,17,Finland,1,1,3,5,1960
359,18,Austria,1,1,0,2,1960
360,18,Yugoslavia,1,1,0,2,1960
361,20,Pakistan,1,0,1,2,1960
362,21,Ethiopia,1,0,0,1,1960
363,21,Greece,1,0,0,1,1960
364,21,Norway,1,0,0,1,1960
365,24,Switzerland,0,3,3,6,1960
366,25,France,0,2,3,5,1960
367,26,Belgium,0,2,2,4,1960
368,27,Iran,0,1,3,4,1960
369,28,Netherlands,0,1,2,3,1960
370,28,South Africa,0,1,2,3,1960
371,30,Argentina,0,1,1,2,1960
372,30,Egypt,0,1,1,2,1960
373,32,Canada,0,1,0,1,1960
374,32,Chinese Taipei,0,1,0,1,1960
375,32,Ghana,0,1,0,1,1960
376,32,India,0,1,0,1,1960
377,32,Morocco,0,1,0,1,1960
378,32,Portugal,0,1,0,1,1960
379,32,Singapore,0,1,0,1,1960
380,39,Brazil,0,0,2,2,1960
381,39,West Indies Federation,0,0,2,2,1960
382,41,Iraq,0,0,1,1,1960
383,41,Mexico,0,0,1,1,1960
384,41,Spain,0,0,1,1,1960
385,41,Venezuela,0,0,1,1,1960
386,1,United States,36,26,28,90,1964
387,2,Soviet Union,30,31,35,96,1964
388,3,Japan,16,5,8,29,1964
389,4,Germany,10,22,18,50,1964
390,5,Italy,10,10,7,27,1964
391,6,Hungary,10,7,5,22,1964
392,7,Poland,7,6,10,23,1964
393,8,Australia,6,2,10,18,1964
394,9,Czechoslovakia,5,6,3,14,1964
395,10,Great Britain,4,12,2,18,1964
396,11,Bulgaria,3,5,2,10,1964
397,12,Finland,3,0,2,5,1964
398,12,New Zealand,3,0,2,5,1964
399,14,Romania,2,4,6,12,1964
400,15,Netherlands,2,4,4,10,1964
401,16,Turkey,2,3,1,6,1964
402,17,Sweden,2,2,4,8,1964
403,18,Denmark,2,1,3,6,1964
404,19,Yugoslavia,2,1,2,5,1964
405,20,Belgium,2,0,1,3,1964
406,21,France,1,8,6,15,1964
407,22,Canada,1,2,1,4,1964
408,22,Switzerland,1,2,1,4,1964
409,24,The Bahamas,1,0,0,1,1964
410,24,Ethiopia,1,0,0,1,1964
411,24,India,1,0,0,1,1964
412,27,Korea,0,2,1,3,1964
413,28,Trinidad and Tobago,0,1,2,3,1964
414,29,Tunisia,0,1,1,2,1964
415,30,Argentina,0,1,0,1,1964
416,30,Cuba,0,1,0,1,1964
417,30,Pakistan,0,1,0,1,1964
418,30,Philippines,0,1,0,1,1964
419,34,Iran,0,0,2,2,1964
420,35,Brazil,0,0,1,1,1964
421,35,Ghana,0,0,1,1,1964
422,35,Ireland,0,0,1,1,1964
423,35,Kenya,0,0,1,1,1964
424,35,Mexico,0,0,1,1,1964
425,35,Nigeria,0,0,1,1,1964
426,35,Uruguay,0,0,1,1,1964
427,1,United States,45,28,34,107,1968
428,2,Soviet Union,29,32,30,91,1968
429,3,Japan,11,7,7,25,1968
430,4,Hungary,10,10,12,32,1968
431,5,East Germany,9,9,7,25,1968
432,6,France,7,3,5,15,1968
433,7,Czechoslovakia,7,2,4,13,1968
434,8,West Germany,5,11,10,26,1968
435,9,Australia,5,7,5,17,1968
436,10,Great Britain,5,5,3,13,1968
437,11,Poland,5,2,11,18,1968
438,12,Romania,4,6,5,15,1968
439,13,Italy,3,4,9,16,1968
440,14,Kenya,3,4,2,9,1968
441,15,Mexico,3,3,3,9,1968
442,16,Yugoslavia,3,3,2,8,1968
443,17,Netherlands,3,3,1,7,1968
444,18,Bulgaria,2,4,3,9,1968
445,19,Iran,2,1,2,5,1968
446,20,Sweden,2,1,1,4,1968
447,21,Turkey,2,0,0,2,1968
448,22,Denmark,1,4,3,8,1968
449,23,Canada,1,3,1,5,1968
450,24,Finland,1,2,1,4,1968
451,25,Ethiopia,1,1,0,2,1968
452,25,Norway,1,1,0,2,1968
453,27,New Zealand,1,0,2,3,1968
454,28,Tunisia,1,0,1,2,1968
455,29,Pakistan,1,0,0,1,1968
456,29,Venezuela,1,0,0,1,1968
457,31,Cuba,0,4,0,4,1968
458,32,Austria,0,2,2,4,1968
459,33,Switzerland,0,1,4,5,1968
460,34,Mongolia,0,1,3,4,1968
461,35,Brazil,0,1,2,3,1968
462,36,Belgium,0,1,1,2,1968
463,36,Korea,0,1,1,2,1968
464,36,Uganda,0,1,1,2,1968
465,39,Cameroon,0,1,0,1,1968
466,39,Jamaica,0,1,0,1,1968
467,41,Argentina,0,0,2,2,1968
468,42,Greece,0,0,1,1,1968
469,42,India,0,0,1,1,1968
470,42,Taiwan,0,0,1,1,1968
471,1,Soviet Union,50,27,22,99,1972
472,2,United States,33,31,30,94,1972
473,3,East Germany,20,23,23,66,1972
474,4,West Germany,13,11,16,40,1972
475,5,Japan,13,8,8,29,1972
476,6,Australia,8,7,2,17,1972
477,7,Poland,7,5,9,21,1972
478,8,Hungary,6,13,16,35,1972
479,9,Bulgaria,6,10,5,21,1972
480,10,Italy,5,3,10,18,1972
481,11,Sweden,4,6,6,16,1972
482,12,Great Britain,4,5,9,18,1972
483,13,Romania,3,6,7,16,1972
484,14,Cuba,3,1,4,8,1972
485,14,Finland,3,1,4,8,1972
486,16,Netherlands,3,1,1,5,1972
487,17,France,2,4,7,13,1972
488,18,Czechoslovakia,2,4,2,8,1972
489,19,Kenya,2,3,4,9,1972
490,20,Yugoslavia,2,1,2,5,1972
491,21,Norway,2,1,1,4,1972
492,22,North Korea,1,1,3,5,1972
493,23,New Zealand,1,1,1,3,1972
494,24,Uganda,1,1,0,2,1972
495,25,Denmark,1,0,0,1,1972
496,26,Switzerland,0,3,0,3,1972
497,27,Canada,0,2,3,5,1972
498,28,Iran,0,2,1,3,1972
499,29,Belgium,0,2,0,2,1972
500,29,Greece,0,2,0,2,1972
501,31,Austria,0,1,2,3,1972
502,31,Colombia,0,1,2,3,1972
503,33,Argentina,0,1,0,1,1972
504,33,Lebanon,0,1,0,1,1972
505,33,Mexico,0,1,0,1,1972
506,33,Mongolia,0,1,0,1,1972
507,33,Pakistan,0,1,0,1,1972
508,33,Korea,0,1,0,1,1972
509,33,Tunisia,0,1,0,1,1972
510,33,Turkey,0,1,0,1,1972
511,41,Brazil,0,0,2,2,1972
512,41,Ethiopia,0,0,2,2,1972
513,43,Ghana,0,0,1,1,1972
514,43,India,0,0,1,1,1972
515,43,Jamaica,0,0,1,1,1972
516,43,Niger,0,0,1,1,1972
517,43,Nigeria,0,0,1,1,1972
518,43,Spain,0,0,1,1,1972
519,1,Soviet Union,49,41,35,125,1976
520,2,East Germany,40,25,25,90,1976
521,3,United States,34,35,25,94,1976
522,4,West Germany,10,12,17,39,1976
523,5,Japan,9,6,10,25,1976
524,6,Poland,7,6,13,26,1976
525,7,Bulgaria,6,9,7,22,1976
526,8,Cuba,6,4,3,13,1976
527,9,Romania,4,9,14,27,1976
528,10,Hungary,4,5,13,22,1976
529,11,Finland,4,2,0,6,1976
530,12,Sweden,4,1,0,5,1976
531,13,Great Britain,3,5,5,13,1976
532,14,Italy,2,7,4,13,1976
533,15,France,2,3,4,9,1976
534,16,Yugoslavia,2,3,3,8,1976
535,17,Czechoslovakia,2,2,4,8,1976
536,18,New Zealand,2,1,1,4,1976
537,19,Korea,1,1,4,6,1976
538,20,Switzerland,1,1,2,4,1976
539,21,Jamaica,1,1,0,2,1976
540,21,North Korea,1,1,0,2,1976
541,21,Norway,1,1,0,2,1976
542,24,Denmark,1,0,2,3,1976
543,25,Mexico,1,0,1,2,1976
544,26,Trinidad and Tobago,1,0,0,1,1976
545,27,Canada,0,5,6,11,1976
546,28,Belgium,0,3,3,6,1976
547,29,Netherlands,0,2,3,5,1976
548,30,Portugal,0,2,0,2,1976
549,30,Spain,0,2,0,2,1976
550,32,Australia,0,1,4,5,1976
551,33,Iran,0,1,1,2,1976
552,34,Mongolia,0,1,0,1,1976
553,34,Venezuela,0,1,0,1,1976
554,36,Brazil,0,0,2,2,1976
555,37,Austria,0,0,1,1,1976
556,37,Bermuda,0,0,1,1,1976
557,37,Pakistan,0,0,1,1,1976
558,37,Puerto Rico,0,0,1,1,1976
559,37,Thailand,0,0,1,1,1976
560,1,Soviet Union,80,69,46,195,1980
561,2,East Germany,47,37,42,126,1980
562,3,Bulgaria,8,16,17,41,1980
563,4,Cuba,8,7,5,20,1980
564,5,Italy,8,3,4,15,1980
565,6,Hungary,7,10,15,32,1980
566,7,Romania,6,6,13,25,1980
567,8,France,6,5,3,14,1980
568,9,Great Britain,5,7,9,21,1980
569,10,Poland,3,14,15,32,1980
570,11,Sweden,3,3,6,12,1980
571,12,Finland,3,1,4,8,1980
572,13,Czechoslovakia,2,3,9,14,1980
573,14,Yugoslavia,2,3,4,9,1980
574,15,Australia,2,2,5,9,1980
575,16,Denmark,2,1,2,5,1980
576,17,Brazil,2,0,2,4,1980
577,17,Ethiopia,2,0,2,4,1980
578,19,Switzerland,2,0,0,2,1980
579,20,Spain,1,3,2,6,1980
580,21,Austria,1,2,1,4,1980
581,22,Greece,1,0,2,3,1980
582,23,Belgium,1,0,0,1,1980
583,23,India,1,0,0,1,1980
584,23,Zimbabwe,1,0,0,1,1980
585,26,North Korea,0,3,2,5,1980
586,27,Mongolia,0,2,2,4,1980
587,28,Tanzania,0,2,0,2,1980
588,29,Mexico,0,1,3,4,1980
589,30,Netherlands,0,1,2,3,1980
590,31,Ireland,0,1,1,2,1980
591,32,Uganda,0,1,0,1,1980
592,32,Venezuela,0,1,0,1,1980
593,34,Jamaica,0,0,3,3,1980
594,35,Guyana,0,0,1,1,1980
595,35,Lebanon,0,0,1,1,1980
596,1,United States,83,61,30,174,1984
597,2,Romania,20,16,17,53,1984
598,3,West Germany,17,19,23,59,1984
599,4,China,15,8,9,32,1984
600,5,Italy,14,6,12,32,1984
601,6,Canada,10,18,16,44,1984
602,7,Japan,10,8,14,32,1984
603,8,New Zealand,8,1,2,11,1984
604,9,Yugoslavia,7,4,7,18,1984
605,10,Korea,6,6,7,19,1984
606,11,Great Britain,5,11,21,37,1984
607,12,France,5,7,16,28,1984
608,13,Netherlands,5,2,6,13,1984
609,14,Australia,4,8,12,24,1984
610,15,Finland,4,2,6,12,1984
611,16,Sweden,2,11,6,19,1984
612,17,Mexico,2,3,1,6,1984
613,18,Morocco,2,0,0,2,1984
614,19,Brazil,1,5,2,8,1984
615,20,Spain,1,2,2,5,1984
616,21,Belgium,1,1,2,4,1984
617,22,Austria,1,1,1,3,1984
618,23,Kenya,1,0,2,3,1984
619,23,Portugal,1,0,2,3,1984
620,25,Pakistan,1,0,0,1,1984
621,26,Switzerland,0,4,4,8,1984
622,27,Denmark,0,3,3,6,1984
623,28,Jamaica,0,1,2,3,1984
624,28,Norway,0,1,2,3,1984
625,30,Greece,0,1,1,2,1984
626,30,Nigeria,0,1,1,2,1984
627,30,Puerto Rico,0,1,1,2,1984
628,33,Colombia,0,1,0,1,1984
629,33,Egypt,0,1,0,1,1984
630,33,Ireland,0,1,0,1,1984
631,33,Ivory Coast,0,1,0,1,1984
632,33,Peru,0,1,0,1,1984
633,33,Syria,0,1,0,1,1984
634,33,Thailand,0,1,0,1,1984
635,40,Turkey,0,0,3,3,1984
636,40,Venezuela,0,0,3,3,1984
637,42,Algeria,0,0,2,2,1984
638,43,Cameroon,0,0,1,1,1984
639,43,Chinese Taipei,0,0,1,1,1984
640,43,Dominican Republic,0,0,1,1,1984
641,43,Iceland,0,0,1,1,1984
642,43,Zambia,0,0,1,1,1984
643,1,Soviet Union,55,31,46,132,1988
644,2,East Germany,37,35,30,102,1988
645,3,United States,36,31,27,94,1988
646,4,Korea,12,10,11,33,1988
647,5,West Germany,11,14,15,40,1988
648,6,Hungary,11,6,6,23,1988
649,7,Bulgaria,10,12,13,35,1988
650,8,Romania,7,11,6,24,1988
651,9,France,6,4,6,16,1988
652,10,Italy,6,4,4,14,1988
653,11,China,5,11,12,28,1988
654,12,Great Britain,5,10,9,24,1988
655,13,Kenya,5,2,2,9,1988
656,14,Japan,4,3,7,14,1988
657,15,Australia,3,6,5,14,1988
658,16,Yugoslavia,3,4,5,12,1988
659,17,Czechoslovakia,3,3,2,8,1988
660,18,New Zealand,3,2,8,13,1988
661,19,Canada,3,2,5,10,1988
662,20,Poland,2,5,9,16,1988
663,21,Norway,2,3,0,5,1988
664,22,Netherlands,2,2,5,9,1988
665,23,Denmark,2,1,1,4,1988
666,24,Brazil,1,2,3,6,1988
667,25,Finland,1,1,2,4,1988
668,25,Spain,1,1,2,4,1988
669,27,Turkey,1,1,0,2,1988
670,28,Morocco,1,0,2,3,1988
671,29,Austria,1,0,0,1,1988
672,29,Portugal,1,0,0,1,1988
673,29,Suriname,1,0,0,1,1988
674,32,Sweden,0,4,7,11,1988
675,33,Switzerland,0,2,2,4,1988
676,34,Jamaica,0,2,0,2,1988
677,35,Argentina,0,1,1,2,1988
678,36,Chile,0,1,0,1,1988
679,36,Costa Rica,0,1,0,1,1988
680,36,Indonesia,0,1,0,1,1988
681,36,Iran,0,1,0,1,1988
682,36,Netherlands Antilles,0,1,0,1,1988
683,36,Peru,0,1,0,1,1988
684,36,Senegal,0,1,0,1,1988
685,36,Virgin Islands,0,1,0,1,1988
686,44,Belgium,0,0,2,2,1988
687,44,Mexico,0,0,2,2,1988
688,46,Colombia,0,0,1,1,1988
689,46,Djibouti,0,0,1,1,1988
690,46,Greece,0,0,1,1,1988
691,46,Mongolia,0,0,1,1,1988
692,46,Pakistan,0,0,1,1,1988
693,46,Philippines,0,0,1,1,1988
694,46,Thailand,0,0,1,1,1988
695,1,Unified Team,45,38,29,112,1992
696,2,United States,37,34,37,108,1992
697,3,Germany,33,21,28,82,1992
698,4,China,16,22,16,54,1992
699,5,Cuba,14,6,11,31,1992
700,6,Spain,13,7,2,22,1992
701,7,Korea,12,5,12,29,1992
702,8,Hungary,11,12,7,30,1992
703,9,France,8,5,16,29,1992
704,10,Australia,7,9,11,27,1992
705,11,Canada,7,4,7,18,1992
706,12,Italy,6,5,8,19,1992
707,13,Great Britain,5,3,12,20,1992
708,14,Romania,4,6,8,18,1992
709,15,Czechoslovakia,4,2,1,7,1992
710,16,North Korea,4,0,5,9,1992
711,17,Japan,3,8,11,22,1992
712,18,Bulgaria,3,7,6,16,1992
713,19,Poland,3,6,10,19,1992
714,20,Netherlands,2,6,7,15,1992
715,21,Kenya,2,4,2,8,1992
716,22,Norway,2,4,1,7,1992
717,23,Turkey,2,2,2,6,1992
718,24,Indonesia,2,2,1,5,1992
719,25,Brazil,2,1,0,3,1992
720,26,Greece,2,0,0,2,1992
721,27,Sweden,1,7,4,12,1992
722,28,New Zealand,1,4,5,10,1992
723,29,Finland,1,2,2,5,1992
724,30,Denmark,1,1,4,6,1992
725,31,Morocco,1,1,1,3,1992
726,32,Ireland,1,1,0,2,1992
727,33,Ethiopia,1,0,2,3,1992
728,34,Algeria,1,0,1,2,1992
729,34,Estonia,1,0,1,2,1992
730,34,Lithuania,1,0,1,2,1992
731,37,Switzerland,1,0,0,1,1992
732,38,Jamaica,0,3,1,4,1992
733,38,Nigeria,0,3,1,4,1992
734,40,Latvia,0,2,1,3,1992
735,41,Austria,0,2,0,2,1992
736,41,Namibia,0,2,0,2,1992
737,41,South Africa,0,2,0,2,1992
738,44,Belgium,0,1,2,3,1992
739,44,Croatia,0,1,2,3,1992
740,44,Yugoslavia,0,1,2,3,1992
741,44,Iran,0,1,2,3,1992
742,48,Israel,0,1,1,2,1992
743,49,Chinese Taipei,0,1,0,1,1992
744,49,Mexico,0,1,0,1,1992
745,49,Peru,0,1,0,1,1992
746,52,Mongolia,0,0,2,2,1992
747,52,Slovenia,0,0,2,2,1992
748,54,Argentina,0,0,1,1,1992
749,54,The Bahamas,0,0,1,1,1992
750,54,Colombia,0,0,1,1,1992
751,54,Ghana,0,0,1,1,1992
752,54,Malaysia,0,0,1,1,1992
753,54,Pakistan,0,0,1,1,1992
754,54,Philippines,0,0,1,1,1992
755,54,Puerto Rico,0,0,1,1,1992
756,54,Qatar,0,0,1,1,1992
757,54,Suriname,0,0,1,1,1992
758,54,Thailand,0,0,1,1,1992
759,1,United States,44,32,25,101,1996
760,2,Russia,26,21,16,63,1996
761,3,Germany,20,18,27,65,1996
762,4,China,16,22,12,50,1996
763,5,France,15,7,15,37,1996
764,6,Italy,13,10,12,35,1996
765,7,Australia,9,9,23,41,1996
766,8,Cuba,9,8,8,25,1996
767,9,Ukraine,9,2,12,23,1996
768,10,Korea,7,15,5,27,1996
769,11,Poland,7,5,5,17,1996
770,12,Hungary,7,4,10,21,1996
771,13,Spain,5,6,6,17,1996
772,14,Romania,4,7,9,20,1996
773,15,Netherlands,4,5,10,19,1996
774,16,Greece,4,4,0,8,1996
775,17,Czechia,4,3,4,11,1996
776,18,Switzerland,4,3,0,7,1996
777,19,Denmark,4,1,1,6,1996
778,19,Turkey,4,1,1,6,1996
779,21,Canada,3,11,8,22,1996
780,22,Bulgaria,3,7,5,15,1996
781,23,Japan,3,6,5,14,1996
782,24,Kazakhstan,3,4,4,11,1996
783,25,Brazil,3,3,9,15,1996
784,26,New Zealand,3,2,1,6,1996
785,27,South Africa,3,1,1,5,1996
786,28,Ireland,3,0,1,4,1996
787,29,Sweden,2,4,2,8,1996
788,30,Norway,2,2,3,7,1996
789,31,Belgium,2,2,2,6,1996
790,32,Nigeria,2,1,3,6,1996
791,33,North Korea,2,1,2,5,1996
792,34,Algeria,2,0,1,3,1996
793,34,Ethiopia,2,0,1,3,1996
794,36,Great Britain,1,8,6,15,1996
795,37,Belarus,1,6,8,15,1996
796,38,Kenya,1,4,3,8,1996
797,39,Jamaica,1,3,2,6,1996
798,40,Finland,1,2,1,4,1996
799,41,Yugoslavia,1,1,2,4,1996
800,41,Indonesia,1,1,2,4,1996
801,43,Iran,1,1,1,3,1996
802,43,Slovakia,1,1,1,3,1996
803,45,Armenia,1,1,0,2,1996
804,45,Croatia,1,1,0,2,1996
805,47,Portugal,1,0,1,2,1996
806,47,Thailand,1,0,1,2,1996
807,49,Burundi,1,0,0,1,1996
808,49,Costa Rica,1,0,0,1,1996
809,49,Ecuador,1,0,0,1,1996
810,49,Hong Kong,1,0,0,1,1996
811,49,Syria,1,0,0,1,1996
812,54,Argentina,0,2,1,3,1996
813,55,Namibia,0,2,0,2,1996
814,55,Slovenia,0,2,0,2,1996
815,57,Austria,0,1,2,3,1996
816,58,Malaysia,0,1,1,2,1996
817,58,Moldova,0,1,1,2,1996
818,58,Uzbekistan,0,1,1,2,1996
819,61,Azerbaijan,0,1,0,1,1996
820,61,The Bahamas,0,1,0,1,1996
821,61,Chinese Taipei,0,1,0,1,1996
822,61,Latvia,0,1,0,1,1996
823,61,Philippines,0,1,0,1,1996
824,61,Tonga,0,1,0,1,1996
825,61,Zambia,0,1,0,1,1996
826,68,Georgia,0,0,2,2,1996
827,68,Morocco,0,0,2,2,1996
828,68,Trinidad and Tobago,0,0,2,2,1996
829,71,India,0,0,1,1,1996
830,71,Israel,0,0,1,1,1996
831,71,Lithuania,0,0,1,1,1996
832,71,Mexico,0,0,1,1,1996
833,71,Mongolia,0,0,1,1,1996
834,71,Mozambique,0,0,1,1,1996
835,71,Puerto Rico,0,0,1,1,1996
836,71,Tunisia,0,0,1,1,1996
837,71,Uganda,0,0,1,1,1996
838,1,United States,37,24,32,93,2000
839,2,Russia,32,28,29,89,2000
840,3,China,28,16,14,58,2000
841,4,Australia,16,25,17,58,2000
842,5,Germany,13,17,26,56,2000
843,6,France,13,14,11,38,2000
844,7,Italy,13,8,13,34,2000
845,8,Netherlands,12,9,4,25,2000
846,9,Cuba,11,11,7,29,2000
847,10,Great Britain,11,10,7,28,2000
848,11,Romania,11,6,9,26,2000
849,12,Korea,8,10,10,28,2000
850,13,Hungary,8,6,3,17,2000
851,14,Poland,6,5,3,14,2000
852,15,Japan,5,8,5,18,2000
853,16,Bulgaria,5,6,2,13,2000
854,17,Greece,4,6,3,13,2000
855,18,Sweden,4,5,3,12,2000
856,19,Norway,4,3,3,10,2000
857,20,Ethiopia,4,1,3,8,2000
858,21,Ukraine,3,10,10,23,2000
859,22,Kazakhstan,3,4,0,7,2000
860,23,Belarus,3,3,11,17,2000
861,24,Canada,3,3,8,14,2000
862,25,Spain,3,3,5,11,2000
863,26,Turkey,3,0,2,5,2000
864,27,Iran,3,0,1,4,2000
865,28,Czechia,2,3,3,8,2000
866,29,Kenya,2,3,2,7,2000
867,30,Denmark,2,3,1,6,2000
868,31,Finland,2,1,1,4,2000
869,32,Austria,2,1,0,3,2000
870,33,Lithuania,2,0,3,5,2000
871,34,Azerbaijan,2,0,1,3,2000
872,34,The Bahamas,2,0,1,3,2000
873,36,Slovenia,2,0,0,2,2000
874,37,Switzerland,1,6,2,9,2000
875,38,Indonesia,1,3,2,6,2000
876,39,Slovakia,1,3,1,5,2000
877,40,Mexico,1,2,3,6,2000
878,41,Nigeria,1,2,0,3,2000
879,42,Algeria,1,1,3,5,2000
880,43,Uzbekistan,1,1,2,4,2000
881,44,Yugoslavia,1,1,1,3,2000
882,44,Latvia,1,1,1,3,2000
883,46,New Zealand,1,0,3,4,2000
884,47,Estonia,1,0,2,3,2000
885,47,Thailand,1,0,2,3,2000
886,49,Croatia,1,0,1,2,2000
887,50,Cameroon,1,0,0,1,2000
888,50,Colombia,1,0,0,1,2000
889,50,Mozambique,1,0,0,1,2000
890,53,Brazil,0,6,6,12,2000
891,54,Jamaica,0,6,3,9,2000
892,55,Belgium,0,2,3,5,2000
893,55,South Africa,0,2,3,5,2000
894,57,Argentina,0,2,2,4,2000
895,58,Chinese Taipei,0,1,4,5,2000
896,58,Morocco,0,1,4,5,2000
897,60,North Korea,0,1,3,4,2000
898,61,Moldova,0,1,1,2,2000
899,61,Saudi Arabia,0,1,1,2,2000
900,61,Trinidad and Tobago,0,1,1,2,2000
901,64,Ireland,0,1,0,1,2000
902,64,Sri Lanka,0,1,0,1,2000
903,64,Uruguay,0,1,0,1,2000
904,64,Vietnam,0,1,0,1,2000
905,68,Georgia,0,0,6,6,2000
906,69,Costa Rica,0,0,2,2,2000
907,69,Portugal,0,0,2,2,2000
908,71,Armenia,0,0,1,1,2000
909,71,Barbados,0,0,1,1,2000
910,71,Chile,0,0,1,1,2000
911,71,Iceland,0,0,1,1,2000
912,71,India,0,0,1,1,2000
913,71,Israel,0,0,1,1,2000
914,71,Kuwait,0,0,1,1,2000
915,71,Kyrgyzstan,0,0,1,1,2000
916,71,North Macedonia,0,0,1,1,2000
917,71,Qatar,0,0,1,1,2000
918,1,United States,36,39,26,101,2004
919,2,China,32,17,14,63,2004
920,3,Russia,28,26,36,90,2004
921,4,Australia,17,16,17,50,2004
922,5,Japan,16,9,12,37,2004
923,6,Germany,13,16,20,49,2004
924,7,France,11,9,13,33,2004
925,8,Italy,10,11,11,32,2004
926,9,Korea,9,12,9,30,2004
927,10,Great Britain,9,9,12,30,2004
928,11,Cuba,9,7,11,27,2004
929,12,Hungary,8,6,3,17,2004
930,13,Ukraine,8,5,9,22,2004
931,14,Romania,8,5,6,19,2004
932,15,Greece,6,6,4,16,2004
933,16,Brazil,5,2,3,10,2004
934,17,Norway,5,0,1,6,2004
935,18,Netherlands,4,9,9,22,2004
936,19,Sweden,4,2,1,7,2004
937,20,Spain,3,11,6,20,2004
938,21,Canada,3,6,3,12,2004
939,22,Turkey,3,3,4,10,2004
940,23,Poland,3,2,5,10,2004
941,24,New Zealand,3,2,0,5,2004
942,25,Thailand,3,1,4,8,2004
943,26,Belarus,2,5,6,13,2004
944,27,Austria,2,4,1,7,2004
945,28,Ethiopia,2,3,2,7,2004
946,29,Iran,2,2,2,6,2004
947,29,Slovakia,2,2,2,6,2004
948,31,Chinese Taipei,2,2,1,5,2004
949,32,Georgia,2,2,0,4,2004
950,33,Bulgaria,2,1,9,12,2004
951,34,Denmark,2,1,5,8,2004
952,35,Jamaica,2,1,2,5,2004
953,35,Uzbekistan,2,1,2,5,2004
954,37,Morocco,2,1,0,3,2004
955,38,Argentina,2,0,4,6,2004
956,39,Chile,2,0,1,3,2004
957,40,Kazakhstan,1,4,3,8,2004
958,41,Kenya,1,4,2,7,2004
959,42,Czechia,1,3,5,9,2004
960,43,South Africa,1,3,2,6,2004
961,44,Croatia,1,2,2,5,2004
962,45,Lithuania,1,2,0,3,2004
963,46,Egypt,1,1,3,5,2004
964,46,Switzerland,1,1,3,5,2004
965,48,Indonesia,1,1,2,4,2004
966,49,Zimbabwe,1,1,1,3,2004
967,50,Azerbaijan,1,0,4,5,2004
968,51,Belgium,1,0,2,3,2004
969,52,The Bahamas,1,0,1,2,2004
970,52,Israel,1,0,1,2,2004
971,54,Cameroon,1,0,0,1,2004
972,54,Dominican Republic,1,0,0,1,2004
973,54,United Arab Emirates,1,0,0,1,2004
974,57,North Korea,0,4,1,5,2004
975,58,Latvia,0,4,0,4,2004
976,59,Mexico,0,3,1,4,2004
977,60,Portugal,0,2,1,3,2004
978,61,Finland,0,2,0,2,2004
979,61,Serbia and Montenegro,0,2,0,2,2004
980,63,Slovenia,0,1,3,4,2004
981,64,Estonia,0,1,2,3,2004
982,65,Hong Kong,0,1,0,1,2004
983,65,India,0,1,0,1,2004
984,65,Paraguay,0,1,0,1,2004
985,68,Colombia,0,0,2,2,2004
986,68,Nigeria,0,0,2,2,2004
987,68,Venezuela,0,0,2,2,2004
988,71,Eritrea,0,0,1,1,2004
989,71,Mongolia,0,0,1,1,2004
990,71,Syria,0,0,1,1,2004
991,71,Trinidad and Tobago,0,0,1,1,2004
992,1,China,48,22,30,100,2008
993,2,United States,36,39,37,112,2008
994,3,Russia,24,13,23,60,2008
995,4,Great Britain,19,13,19,51,2008
996,5,Germany,16,11,14,41,2008
997,6,Australia,14,15,17,46,2008
998,7,Korea,13,11,8,32,2008
999,8,Japan,9,8,8,25,2008
1000,9,Italy,8,9,10,27,2008
1001,10,France,7,16,20,43,2008
1002,11,Netherlands,7,5,4,16,2008
1003,12,Ukraine,7,4,11,22,2008
1004,13,Kenya,6,4,6,16,2008
1005,14,Spain,5,11,3,19,2008
1006,15,Jamaica,5,4,2,11,2008
1007,16,Poland,4,5,2,11,2008
1008,17,Ethiopia,4,2,1,7,2008
1009,18,Romania,4,1,4,9,2008
1010,19,Cuba,3,10,17,30,2008
1011,20,Canada,3,9,8,20,2008
1012,21,Hungary,3,5,2,10,2008
1013,22,Norway,3,5,1,9,2008
1014,23,Brazil,3,4,10,17,2008
1015,24,Belarus,3,4,7,14,2008
1016,25,Czechia,3,3,1,7,2008
1017,26,Slovakia,3,3,0,6,2008
1018,27,New Zealand,3,2,4,9,2008
1019,28,Georgia,3,2,2,7,2008
1020,29,Kazakhstan,2,3,4,9,2008
1021,30,Denmark,2,2,3,7,2008
1022,31,North Korea,2,2,2,6,2008
1023,31,Thailand,2,2,2,6,2008
1024,33,Mongolia,2,2,0,4,2008
1025,34,Switzerland,2,1,4,7,2008
1026,35,Argentina,2,0,4,6,2008
1027,36,Mexico,2,0,2,4,2008
1028,37,Belgium,2,0,0,2,2008
1029,38,Zimbabwe,1,3,0,4,2008
1030,39,Slovenia,1,2,2,5,2008
1031,40,Azerbaijan,1,1,4,6,2008
1032,40,Indonesia,1,1,4,6,2008
1033,42,Bulgaria,1,1,3,5,2008
1034,42,Turkey,1,1,3,5,2008
1035,44,Chinese Taipei,1,1,2,4,2008
1036,44,Finland,1,1,2,4,2008
1037,46,Latvia,1,1,1,3,2008
1038,47,Dominican Republic,1,1,0,2,2008
1039,47,Estonia,1,1,0,2,2008
1040,47,Portugal,1,1,0,2,2008
1041,47,Trinidad and Tobago,1,1,0,2,2008
1042,51,India,1,0,2,3,2008
1043,52,Iran,1,0,1,2,2008
1044,53,Cameroon,1,0,0,1,2008
1045,53,Panama,1,0,0,1,2008
1046,53,Tunisia,1,0,0,1,2008
1047,56,Sweden,0,4,1,5,2008
1048,57,Lithuania,0,3,2,5,2008
1049,57,Nigeria,0,3,2,5,2008
1050,59,Croatia,0,2,3,5,2008
1051,60,Colombia,0,2,1,3,2008
1052,60,Greece,0,2,1,3,2008
1053,62,Armenia,0,1,4,5,2008
1054,63,Uzbekistan,0,1,3,4,2008
1055,64,Austria,0,1,2,3,2008
1056,64,Ireland,0,1,2,3,2008
1057,64,Kyrgyzstan,0,1,2,3,2008
1058,64,Serbia,0,1,2,3,2008
1059,68,Algeria,0,1,1,2,2008
1060,68,The Bahamas,0,1,1,2,2008
1061,68,Morocco,0,1,1,2,2008
1062,68,Tajikistan,0,1,1,2,2008
1063,72,Chile,0,1,0,1,2008
1064,72,Ecuador,0,1,0,1,2008
1065,72,Iceland,0,1,0,1,2008
1066,72,Malaysia,0,1,0,1,2008
1067,72,Samoa,0,1,0,1,2008
1068,72,Singapore,0,1,0,1,2008
1069,72,South Africa,0,1,0,1,2008
1070,72,Sudan,0,1,0,1,2008
1071,72,Vietnam,0,1,0,1,2008
1072,81,Egypt,0,0,2,2,2008
1073,82,Afghanistan,0,0,1,1,2008
1074,82,Israel,0,0,1,1,2008
1075,82,Mauritius,0,0,1,1,2008
1076,82,Moldova,0,0,1,1,2008
1077,82,Togo,0,0,1,1,2008
1078,82,Venezuela,0,0,1,1,2008
1079,1,United States,48,26,30,104,2012
1080,2,China,39,31,22,92,2012
1081,3,Great Britain,29,18,18,65,2012
1082,4,Russia,18,21,26,65,2012
1083,5,Korea,13,9,9,31,2012
1084,6,Germany,11,20,13,44,2012
1085,7,France,11,11,13,35,2012
1086,8,Australia,8,15,12,35,2012
1087,9,Italy,8,9,11,28,2012
1088,10,Hungary,8,4,6,18,2012
1089,11,Japan,7,14,17,38,2012
1090,12,Iran,7,5,1,13,2012
1091,13,Netherlands,6,6,8,20,2012
1092,14,New Zealand,6,2,5,13,2012
1093,15,Ukraine,5,4,10,19,2012
1094,16,Cuba,5,3,7,15,2012
1095,17,Spain,4,10,6,20,2012
1096,18,Jamaica,4,5,4,13,2012
1097,19,Czechia,4,4,3,11,2012
1098,20,South Africa,4,1,1,6,2012
1099,21,North Korea,4,0,2,6,2012
1100,22,Brazil,3,5,9,17,2012
1101,23,Kazakhstan,3,2,6,11,2012
1102,23,Poland,3,2,6,11,2012
1103,25,Ethiopia,3,2,3,8,2012
1104,26,Croatia,3,1,2,6,2012
1105,27,Canada,2,6,10,18,2012
1106,28,Belarus,2,5,3,10,2012
1107,29,Kenya,2,4,7,13,2012
1108,30,Denmark,2,4,3,9,2012
1109,31,Romania,2,4,1,7,2012
1110,32,Azerbaijan,2,2,5,9,2012
1111,33,Switzerland,2,2,0,4,2012
1112,34,Norway,2,1,1,4,2012
1113,35,Lithuania,2,0,3,5,2012
1114,36,Tunisia,2,0,1,3,2012
1115,37,Sweden,1,4,3,8,2012
1116,38,Colombia,1,3,5,9,2012
1117,39,Mexico,1,3,4,8,2012
1118,40,Georgia,1,2,3,6,2012
1119,41,Ireland,1,1,4,6,2012
1120,42,Argentina,1,1,2,4,2012
1121,42,Serbia,1,1,2,4,2012
1122,42,Slovenia,1,1,2,4,2012
1123,42,Trinidad and Tobago,1,1,2,4,2012
1124,46,Turkey,1,1,1,3,2012
1125,47,Dominican Republic,1,1,0,2,2012
1126,48,Chinese Taipei,1,0,1,2,2012
1127,48,Latvia,1,0,1,2,2012
1128,50,Algeria,1,0,0,1,2012
1129,50,The Bahamas,1,0,0,1,2012
1130,50,Bahrain,1,0,0,1,2012
1131,50,Grenada,1,0,0,1,2012
1132,50,Uganda,1,0,0,1,2012
1133,50,Venezuela,1,0,0,1,2012
1134,56,Egypt,0,3,1,4,2012
1135,57,India,0,2,4,6,2012
1136,58,Mongolia,0,2,3,5,2012
1137,59,Thailand,0,2,2,4,2012
1138,60,Bulgaria,0,2,1,3,2012
1139,60,Finland,0,2,1,3,2012
1140,60,Indonesia,0,2,1,3,2012
1141,63,Slovakia,0,1,3,4,2012
1142,64,Belgium,0,1,2,3,2012
1143,65,Armenia,0,1,1,2,2012
1144,65,Estonia,0,1,1,2,2012
1145,65,Malaysia,0,1,1,2,2012
1146,65,Puerto Rico,0,1,1,2,2012
1147,65,Qatar,0,1,1,2,2012
1148,70,Botswana,0,1,0,1,2012
1149,70,Cyprus,0,1,0,1,2012
1150,70,Gabon,0,1,0,1,2012
1151,70,Guatemala,0,1,0,1,2012
1152,70,Montenegro,0,1,0,1,2012
1153,70,Portugal,0,1,0,1,2012
1154,76,Uzbekistan,0,0,3,3,2012
1155,77,Greece,0,0,2,2,2012
1156,77,Singapore,0,0,2,2,2012
1157,79,Afghanistan,0,0,1,1,2012
1158,79,Cameroon,0,0,1,1,2012
1159,79,Hong Kong,0,0,1,1,2012
1160,79,Kuwait,0,0,1,1,2012
1161,79,Morocco,0,0,1,1,2012
1162,79,Saudi Arabia,0,0,1,1,2012
1163,79,Tajikistan,0,0,1,1,2012
1164,79,Vietnam,0,0,1,1,2012
1165,1,United States,46,37,38,121,2016
1166,2,Great Britain,27,23,17,67,2016
1167,3,China,26,18,26,70,2016
1168,4,Russia,19,17,20,56,2016
1169,5,Germany,17,10,15,42,2016
1170,6,Japan,12,8,21,41,2016
1171,7,France,10,18,14,42,2016
1172,8,Korea,9,3,9,21,2016
1173,9,Italy,8,12,8,28,2016
1174,10,Australia,8,11,10,29,2016
1175,11,Netherlands,8,7,4,19,2016
1176,12,Hungary,8,3,4,15,2016
1177,13,Brazil,7,6,6,19,2016
1178,14,Spain,7,4,6,17,2016
1179,15,Kenya,6,6,1,13,2016
1180,16,Jamaica,6,3,2,11,2016
1181,17,Croatia,5,3,2,10,2016
1182,18,Cuba,5,2,4,11,2016
1183,19,New Zealand,4,9,5,18,2016
1184,20,Canada,4,3,15,22,2016
1185,21,Uzbekistan,4,2,7,13,2016
1186,22,Colombia,3,2,3,8,2016
1187,23,Switzerland,3,2,2,7,2016
1188,24,Iran,3,1,4,8,2016
1189,25,Greece,3,1,2,6,2016
1190,26,Argentina,3,1,0,4,2016
1191,27,Denmark,2,6,7,15,2016
1192,28,Sweden,2,6,3,11,2016
1193,29,South Africa,2,6,2,10,2016
1194,30,Kazakhstan,2,5,10,17,2016
1195,31,Ukraine,2,5,4,11,2016
1196,32,Serbia,2,4,2,8,2016
1197,33,Poland,2,3,6,11,2016
1198,34,North Korea,2,3,2,7,2016
1199,35,Belgium,2,2,2,6,2016
1200,35,Thailand,2,2,2,6,2016
1201,37,Slovakia,2,2,0,4,2016
1202,38,Georgia,2,1,4,7,2016
1203,39,Azerbaijan,1,7,10,18,2016
1204,40,Belarus,1,4,4,9,2016
1205,41,Turkey,1,3,4,8,2016
1206,42,Armenia,1,3,0,4,2016
1207,43,Czechia,1,2,7,10,2016
1208,44,Ethiopia,1,2,5,8,2016
1209,45,Slovenia,1,2,1,4,2016
1210,46,Indonesia,1,2,0,3,2016
1211,47,Romania,1,1,2,4,2016
1212,48,Bahrain,1,1,0,2,2016
1213,48,Vietnam,1,1,0,2,2016
1214,50,Chinese Taipei,1,0,2,3,2016
1215,51,The Bahamas,1,0,1,2,2016
1216,51,Independent Olympic Athletes,1,0,1,2,2016
1217,51,Ivory Coast,1,0,1,2,2016
1218,54,Fiji,1,0,0,1,2016
1219,54,Jordan,1,0,0,1,2016
1220,54,Kosovo,1,0,0,1,2016
1221,54,Puerto Rico,1,0,0,1,2016
1222,54,Singapore,1,0,0,1,2016
1223,54,Tajikistan,1,0,0,1,2016
1224,60,Malaysia,0,4,1,5,2016
1225,61,Mexico,0,3,2,5,2016
1226,62,Venezuela,0,2,1,3,2016
1227,63,Algeria,0,2,0,2,2016
1228,63,Ireland,0,2,0,2,2016
1229,65,Lithuania,0,1,3,4,2016
1230,66,Bulgaria,0,1,2,3,2016
1231,67,India,0,1,1,2,2016
1232,67,Mongolia,0,1,1,2,2016
1233,69,Burundi,0,1,0,1,2016
1234,69,Grenada,0,1,0,1,2016
1235,69,Niger,0,1,0,1,2016
1236,69,Philippines,0,1,0,1,2016
1237,69,Qatar,0,1,0,1,2016
1238,74,Norway,0,0,4,4,2016
1239,75,Egypt,0,0,3,3,2016
1240,75,Tunisia,0,0,3,3,2016
1241,77,Israel,0,0,2,2,2016
1242,78,Austria,0,0,1,1,2016
1243,78,Dominican Republic,0,0,1,1,2016
1244,78,Estonia,0,0,1,1,2016
1245,78,Finland,0,0,1,1,2016
1246,78,Morocco,0,0,1,1,2016
1247,78,Nigeria,0,0,1,1,2016
1248,78,Portugal,0,0,1,1,2016
1249,78,Trinidad and Tobago,0,0,1,1,2016
1250,78,United Arab Emirates,0,0,1,1,2016
1251,1,United States,39,41,33,113,2020
1252,2,China,38,32,19,89,2020
1253,3,Japan,27,14,17,58,2020
1254,4,Great Britain,22,20,22,64,2020
1255,5,ROC,20,28,23,71,2020
1256,6,Australia,17,7,22,46,2020
1257,7,Netherlands,10,12,14,36,2020
1258,8,France,10,12,11,33,2020
1259,9,Germany,10,11,16,37,2020
1260,10,Italy,10,10,20,40,2020
1261,11,Canada,7,7,10,24,2020
1262,12,Brazil,7,6,8,21,2020
1263,13,New Zealand,7,6,7,20,2020
1264,14,Cuba,7,3,5,15,2020
1265,15,Hungary,6,7,7,20,2020
1266,16,Korea,6,4,10,20,2020
1267,17,Poland,4,5,5,14,2020
1268,18,Czechia,4,4,3,11,2020
1269,19,Kenya,4,4,2,10,2020
1270,20,Norway,4,2,2,8,2020
1271,21,Jamaica,4,1,4,9,2020
1272,22,Spain,3,8,6,17,2020
1273,23,Sweden,3,6,0,9,2020
1274,24,Switzerland,3,4,6,13,2020
1275,25,Denmark,3,4,4,11,2020
1276,26,Croatia,3,3,2,8,2020
1277,27,Iran,3,2,2,7,2020
1278,28,Serbia,3,1,5,9,2020
1279,29,Belgium,3,1,3,7,2020
1280,30,Bulgaria,3,1,2,6,2020
1281,31,Slovenia,3,1,1,5,2020
1282,32,Uzbekistan,3,0,2,5,2020
1283,33,Georgia,2,5,1,8,2020
1284,34,Chinese Taipei,2,4,6,12,2020
1285,35,Turkey,2,2,9,13,2020
1286,36,Greece,2,1,1,4,2020
1287,36,Uganda,2,1,1,4,2020
1288,38,Ecuador,2,1,0,3,2020
1289,39,Ireland,2,0,2,4,2020
1290,39,Israel,2,0,2,4,2020
1291,41,Qatar,2,0,1,3,2020
1292,42,The Bahamas,2,0,0,2,2020
1293,42,Kosovo,2,0,0,2,2020
1294,44,Ukraine,1,6,12,19,2020
1295,45,Belarus,1,3,3,7,2020
1296,46,Romania,1,3,0,4,2020
1297,46,Venezuela,1,3,0,4,2020
1298,48,India,1,2,4,7,2020
1299,49,Hong Kong,1,2,3,6,2020
1300,50,Philippines,1,2,1,4,2020
1301,50,Slovakia,1,2,1,4,2020
1302,52,South Africa,1,2,0,3,2020
1303,53,Austria,1,1,5,7,2020
1304,54,Egypt,1,1,4,6,2020
1305,55,Indonesia,1,1,3,5,2020
1306,56,Ethiopia,1,1,2,4,2020
1307,56,Portugal,1,1,2,4,2020
1308,58,Tunisia,1,1,0,2,2020
1309,59,Estonia,1,0,1,2,2020
1310,59,Fiji,1,0,1,2,2020
1311,59,Latvia,1,0,1,2,2020
1312,59,Thailand,1,0,1,2,2020
1313,63,Bermuda,1,0,0,1,2020
1314,63,Morocco,1,0,0,1,2020
1315,63,Puerto Rico,1,0,0,1,2020
1316,66,Colombia,0,4,1,5,2020
1317,67,Azerbaijan,0,3,4,7,2020
1318,68,Dominican Republic,0,3,2,5,2020
1319,69,Armenia,0,2,2,4,2020
1320,70,Kyrgyzstan,0,2,1,3,2020
1321,71,Mongolia,0,1,3,4,2020
1322,72,Argentina,0,1,2,3,2020
1323,72,San Marino,0,1,2,3,2020
1324,74,Jordan,0,1,1,2,2020
1325,74,Malaysia,0,1,1,2,2020
1326,74,Nigeria,0,1,1,2,2020
1327,77,Bahrain,0,1,0,1,2020
1328,77,Lithuania,0,1,0,1,2020
1329,77,Namibia,0,1,0,1,2020
1330,77,North Macedonia,0,1,0,1,2020
1331,77,Saudi Arabia,0,1,0,1,2020
1332,77,Turkmenistan,0,1,0,1,2020
1333,83,Kazakhstan,0,0,8,8,2020
1334,84,Mexico,0,0,4,4,2020
1335,85,Finland,0,0,2,2,2020
1336,86,Botswana,0,0,1,1,2020
1337,86,Burkina Faso,0,0,1,1,2020
1338,86,Ghana,0,0,1,1,2020
1339,86,Grenada,0,0,1,1,2020
1340,86,Ivory Coast,0,0,1,1,2020
1341,86,Kuwait,0,0,1,1,2020
1342,86,Moldova,0,0,1,1,2020
1343,86,Syria,0,0,1,1,2020
1344,1,United States,40,44,42,126,2024
1345,2,China,40,27,24,91,2024
1346,3,Japan,20,12,13,45,2024
1347,4,Australia,18,19,16,53,2024
1348,5,France,16,26,22,64,2024
1349,6,Netherlands,15,7,12,34,2024
1350,7,Great Britain,14,22,29,65,2024
1351,8,Korea,13,9,10,32,2024
1352,9,Italy,12,13,15,40,2024
1353,10,Germany,12,13,8,33,2024
1354,11,New Zealand,10,7,3,20,2024
1355,12,Canada,9,7,11,27,2024
1356,13,Uzbekistan,8,2,3,13,2024
1357,14,Hungary,6,7,6,19,2024
1358,15,Spain,5,4,9,18,2024
1359,16,Sweden,4,4,3,11,2024
1360,17,Kenya,4,2,5,11,2024
1361,18,Norway,4,1,3,8,2024
1362,19,Ireland,4,0,3,7,2024
1363,20,Brazil,3,7,10,20,2024
1364,21,Iran,3,6,3,12,2024
1365,22,Ukraine,3,5,4,12,2024
1366,23,Romania,3,4,2,9,2024
1367,24,Georgia,3,3,1,7,2024
1368,25,Belgium,3,1,6,10,2024
1369,26,Bulgaria,3,1,3,7,2024
1370,27,Serbia,3,1,1,5,2024
1371,28,Czechia,3,0,2,5,2024
1372,29,Denmark,2,2,5,9,2024
1373,30,Azerbaijan,2,2,3,7,2024
1374,30,Croatia,2,2,3,7,2024
1375,32,Cuba,2,1,6,9,2024
1376,33,Bahrain,2,1,1,4,2024
1377,34,Slovenia,2,1,0,3,2024
1378,35,Chinese Taipei,2,0,5,7,2024
1379,36,Austria,2,0,3,5,2024
1380,37,Hong Kong,2,0,2,4,2024
1381,37,Philippines,2,0,2,4,2024
1382,39,Algeria,2,0,1,3,2024
1383,39,Indonesia,2,0,1,3,2024
1384,41,Israel,1,5,1,7,2024
1385,42,Poland,1,4,5,10,2024
1386,43,Kazakhstan,1,3,3,7,2024
1387,44,Jamaica,1,3,2,6,2024
1388,44,South Africa,1,3,2,6,2024
1389,44,Thailand,1,3,2,6,2024
1390,47,Ethiopia,1,3,0,4,2024
1391,48,Switzerland,1,2,5,8,2024
1392,49,Ecuador,1,2,2,5,2024
1393,50,Portugal,1,2,1,4,2024
1394,51,Greece,1,1,6,8,2024
1395,52,Argentina,1,1,1,3,2024
1396,52,Egypt,1,1,1,3,2024
1397,52,Tunisia,1,1,1,3,2024
1398,55,Botswana,1,1,0,2,2024
1399,55,Chile,1,1,0,2,2024
1400,55,Saint Lucia,1,1,0,2,2024
1401,55,Uganda,1,1,0,2,2024
1402,59,Dominican Republic,1,0,2,3,2024
1403,60,Guatemala,1,0,1,2,2024
1404,60,Morocco,1,0,1,2,2024
1405,62,Dominica,1,0,0,1,2024
1406,62,Pakistan,1,0,0,1,2024
1407,64,Turkey,0,3,5,8,2024
1408,65,Mexico,0,3,2,5,2024
1409,66,Armenia,0,3,1,4,2024
1410,66,Colombia,0,3,1,4,2024
1411,68,Kyrgyzstan,0,2,4,6,2024
1412,68,North Korea,0,2,4,6,2024
1413,70,Lithuania,0,2,2,4,2024
1414,71,India,0,1,5,6,2024
1415,72,Moldova,0,1,3,4,2024
1416,73,Kosovo,0,1,1,2,2024
1417,74,Cyprus,0,1,0,1,2024
1418,74,Fiji,0,1,0,1,2024
1419,74,Jordan,0,1,0,1,2024
1420,74,Mongolia,0,1,0,1,2024
1421,74,Panama,0,1,0,1,2024
1422,79,Tajikistan,0,0,3,3,2024
1423,80,Albania,0,0,2,2,2024
1424,80,Grenada,0,0,2,2,2024
1425,80,Malaysia,0,0,2,2,2024
1426,80,Puerto Rico,0,0,2,2,2024
1427,84,Cabo Verde,0,0,1,1,2024
1428,84,Ivory Coast,0,0,1,1,2024
1429,84,Peru,0,0,1,1,2024
1430,84,Qatar,0,0,1,1,2024
1431,84,Refugee Olympic Team,0,0,1,1,2024
1432,84,Singapore,0,0,1,1,2024
1433,84,Slovakia,0,0,1,1,2024
1434,84,Zambia,0,0,1,1,2024
